//MAP CONVERTED BY dmm2tgm.py THIS HEADER COMMENT PREVENTS RECONVERSION, DO NOT REMOVE
"aq" = (
/obj/structure/chair/pew{
	dir = 1
	},
/obj/structure/window/reinforced/tinted/frosted,
/turf/open/floor/wood_common/wood_common_dark,
/area/hilbertshotel)
"aA" = (
/obj/structure/window/reinforced/tinted/frosted{
	dir = 4
	},
/obj/structure/chair/pew,
/turf/open/floor/wood_common/wood_common_dark,
/area/hilbertshotel)
"aY" = (
/obj/structure/table,
/obj/machinery/microwave{
	pixel_y = 6
	},
/obj/structure/window/reinforced{
	dir = 1;
	layer = 2.9
	},
/turf/open/floor/plasteel/cafeteria,
/area/hilbertshotel)
"bt" = (
/obj/effect/turf_decal/siding/wood{
	dir = 8
	},
/turf/open/floor/wood_common/wood_common_dark,
/area/hilbertshotel)
"bI" = (
/obj/structure/sign/poster/contraband/random{
	pixel_x = 29
	},
/turf/open/floor/carpet/black,
/area/hilbertshotel)
"cH" = (
/obj/structure/table,
/obj/item/reagent_containers/food/condiment/peppermill,
/obj/item/reagent_containers/food/condiment/saltshaker{
	pixel_y = 9
	},
/obj/item/sharpener{
	pixel_x = 10
	},
/turf/open/floor/plasteel/cafeteria,
/area/hilbertshotel)
"cV" = (
/obj/machinery/shower{
	desc = "Despite their age, they seem clean and capable of providing hot water just as well as their modern counterparts. Hopefully Nanotrasen cleaned the water pipes this well...";
	dir = 4
	},
/turf/open/floor/wood_common/wood_common_dark,
/area/hilbertshotel)
"dx" = (
/obj/structure/chair/comfy/black{
	pixel_y = 6;
	dir = 8
	},
/turf/open/floor/carpet/royalblack,
/area/hilbertshotel)
"dQ" = (
/obj/machinery/telecomms/relay/preset/auto,
/turf/open/floor/wood_common/wood_common_dark,
/area/hilbertshotel)
"eH" = (
/obj/structure/mineral_door/transparent,
/turf/open/floor/pod/dark,
/area/hilbertshotel)
"fq" = (
/turf/open/floor/carpet/red,
/area/hilbertshotel)
"fr" = (
/obj/structure/fans/tiny/invisible,
/turf/open/floor/wood_common/wood_common_dark,
/area/hilbertshotel)
"fs" = (
/obj/structure/sign/poster/contraband/random{
	pixel_x = -31
	},
/turf/open/floor/wood_common/wood_common_dark,
/area/hilbertshotel)
"fB" = (
/obj/machinery/light{
	dir = 4
	},
/turf/open/floor/plasteel/cafeteria,
/area/hilbertshotel)
"gj" = (
/obj/structure/mineral_door/wood,
/area/hilbertshotel)
"id" = (
/obj/structure/table,
/turf/open/floor/pod/light,
/area/hilbertshotel)
"ix" = (
/obj/effect/turf_decal/siding/wood{
	dir = 6
	},
/turf/open/floor/carpet/royalblue,
/area/hilbertshotel)
"jC" = (
/obj/structure/falsewall/brick,
/turf/open/floor/pod/light,
/area/hilbertshotel)
"kg" = (
/obj/structure/closet/crate/bin,
/turf/open/floor/carpet/red,
/area/hilbertshotel)
"ki" = (
/obj/structure/fireplace{
	dir = 8
	},
/turf/open/floor/wood_common/wood_common_dark,
/area/hilbertshotel)
"kz" = (
/turf/open/floor/pod/dark,
/area/hilbertshotel)
"lq" = (
/turf/open/floor/plasteel/cafeteria,
/area/hilbertshotel)
"lR" = (
/obj/structure/chair/sofa/corp/right{
	dir = 1
	},
/turf/open/floor/wood_common/wood_common_dark,
/area/hilbertshotel)
"md" = (
/obj/machinery/light{
	dir = 8
	},
/obj/effect/decal/cleanable/ash,
/turf/open/floor/carpet/black,
/area/hilbertshotel)
"nA" = (
/obj/structure/window/reinforced/tinted/frosted,
/obj/structure/reagent_dispensers/watertank,
/turf/open/floor/wood_common/wood_common_dark,
/area/hilbertshotel)
"nF" = (
/turf/open/floor/carpet/black,
/area/hilbertshotel)
"nH" = (
/obj/machinery/light{
	dir = 4
	},
/turf/open/floor/wood_common/wood_common_dark,
/area/hilbertshotel)
"oa" = (
/obj/machinery/light/floor{
	bulb_colour = "#F27D0C"
	},
/turf/open/floor/wood_common/wood_common_dark,
/area/hilbertshotel)
"pu" = (
/obj/structure/showcase/machinery/tv,
/obj/structure/table,
/turf/open/floor/wood_common/wood_common_dark,
/area/hilbertshotel)
"pH" = (
/turf/open/floor/carpet/royalblue,
/area/hilbertshotel)
"rj" = (
/obj/machinery/light{
	dir = 1
	},
/obj/effect/turf_decal/siding{
	dir = 4
	},
/turf/open/floor/wood_common/wood_common_dark,
/area/hilbertshotel)
"rk" = (
/obj/structure/chair/sofa/corp{
	dir = 1
	},
/turf/open/floor/wood_common/wood_common_dark,
/area/hilbertshotel)
"ry" = (
/obj/structure/closet/cabinet{
	pixel_x = -6
	},
/turf/open/floor/carpet/royalblack,
/area/hilbertshotel)
"sp" = (
/turf/open/floor/wood_common/wood_common_dark,
/area/hilbertshotel)
"sr" = (
/turf/closed/wall/mineral/brick,
/area/hilbertshotel)
"sU" = (
/obj/item/kirbyplants/random,
/turf/closed/wall/mineral/brick,
/area/hilbertshotel)
"sV" = (
/obj/machinery/vending/dinnerware{
	contraband = list(/obj/item/kitchen/rollingpin=2,/obj/item/kitchen/knife/butcher=2,/obj/item/reagent_containers/food/condiment/flour=4);
	shut_up = 1
	},
/turf/open/floor/plasteel/cafeteria,
/area/hilbertshotel)
"tm" = (
/obj/effect/turf_decal/siding/wood{
	dir = 1
	},
/turf/open/floor/carpet/royalblue,
/area/hilbertshotel)
"tA" = (
/obj/effect/turf_decal/siding/wood{
	dir = 9
	},
/turf/open/floor/carpet/royalblue,
/area/hilbertshotel)
"tQ" = (
/obj/structure/closet/cabinet,
/turf/open/floor/wood_common/wood_common_dark,
/area/hilbertshotel)
"tR" = (
/obj/machinery/door/morgue,
/turf/open/floor/wood_common/wood_common_dark,
/area/hilbertshotel)
"vv" = (
/obj/structure/closet/crate/wooden,
/obj/item/stack/sheet/mineral/wood/fifty,
/turf/open/floor/wood_common/wood_common_dark,
/area/hilbertshotel)
"vP" = (
/obj/structure/chair/sofa/corp{
	dir = 4
	},
/turf/open/floor/wood_common/wood_common_dark,
/area/hilbertshotel)
"vZ" = (
/obj/machinery/smartfridge/food,
/turf/closed/wall/mineral/brick,
/area/hilbertshotel)
"ww" = (
/obj/structure/chair/pew/left,
/turf/open/floor/wood_common/wood_common_dark,
/area/hilbertshotel)
"xn" = (
/obj/structure/chair{
	dir = 4
	},
/turf/open/floor/pod/light,
/area/hilbertshotel)
"xp" = (
/obj/structure/window/reinforced{
	dir = 8
	},
/turf/open/floor/wood_common/wood_common_dark,
/area/hilbertshotel)
"xt" = (
/obj/structure/lattice,
/turf/open/space/bluespace,
/area/hilbertshotel)
"yc" = (
/obj/structure/table,
/obj/effect/turf_decal/siding/wood{
	dir = 8
	},
/obj/item/storage/fancy/heart_box,
/obj/item/paper/fluff/hilbertshotel/welcomeletter,
/turf/open/floor/carpet/royalblue,
/area/hilbertshotel)
"yJ" = (
/obj/structure/window/reinforced/tinted/frosted{
	dir = 4
	},
/obj/structure/chair/pew{
	dir = 1
	},
/obj/structure/window/reinforced/tinted/frosted,
/turf/open/floor/wood_common/wood_common_dark,
/area/hilbertshotel)
"Am" = (
/obj/machinery/button{
	pixel_y = 26;
	id = "elevator"
	},
/obj/machinery/button{
	pixel_y = 37;
	id = "elevator"
	},
/obj/structure/extinguisher_cabinet{
	pixel_x = 30
	},
/turf/open/floor/carpet/black,
/area/hilbertshotel)
"Au" = (
/obj/structure/sink/kitchen{
	dir = 8;
	pixel_x = 11
	},
/turf/open/floor/plasteel/cafeteria,
/area/hilbertshotel)
"Cf" = (
/obj/effect/turf_decal/siding/wood,
/turf/open/floor/carpet/royalblue,
/area/hilbertshotel)
"CD" = (
/turf/open/floor/pod/light,
/area/hilbertshotel)
"DR" = (
/obj/structure/table,
/obj/effect/spawner/lootdrop/three_course_meal,
/obj/machinery/reagentgrinder{
	pixel_y = 8
	},
/turf/open/floor/plasteel/cafeteria,
/area/hilbertshotel)
"Ex" = (
/turf/closed/indestructible/hoteldoor{
	icon_state = "door_closed";
	icon = 'icons/obj/doors/puzzledoor/default.dmi'
	},
/area/hilbertshotel)
"EB" = (
/obj/machinery/light{
	bulb_colour = "FFB43A"
	},
/turf/open/floor/wood_common/wood_common_dark,
/area/hilbertshotel)
"EV" = (
/obj/machinery/light{
	dir = 1
	},
/obj/structure/closet/crate/wooden,
/obj/item/stack/sheet/mineral/wood/fifty,
/turf/open/floor/wood_common/wood_common_dark,
/area/hilbertshotel)
"Fh" = (
/obj/structure/closet/crate,
/obj/item/stack/sheet/mineral/wood/fifty,
/obj/item/reagent_containers/glass/bucket{
	pixel_y = 7
	},
/turf/open/floor/wood_common/wood_common_dark,
/area/hilbertshotel)
"Fi" = (
/turf/open/floor/carpet/royalblack,
/area/hilbertshotel)
"Ft" = (
/obj/structure/toilet{
	dir = 4
	},
/obj/machinery/light/floor,
/turf/open/floor/wood_common/wood_common_dark,
/area/hilbertshotel)
"Gi" = (
/obj/structure/bedsheetbin/towel,
/obj/structure/table,
/obj/machinery/light{
	dir = 1;
	bulb_colour = "FFB43A"
	},
/turf/open/floor/wood_common/wood_common_dark,
/area/hilbertshotel)
"Gk" = (
/obj/structure/table,
/obj/effect/turf_decal/siding/wood{
	dir = 10
	},
/turf/open/floor/carpet/royalblue,
/area/hilbertshotel)
"Gm" = (
/obj/structure/sign/poster/contraband/random{
	pixel_x = 29
	},
/turf/closed/wall/mineral/brick,
/area/hilbertshotel)
"HZ" = (
/obj/structure/table,
/obj/item/electropack/shockcollar,
/obj/effect/decal/cleanable/cobweb,
/turf/open/floor/pod/light,
/area/hilbertshotel)
"IJ" = (
/obj/item/kirbyplants/random,
/turf/open/floor/wood_common/wood_common_dark,
/area/hilbertshotel)
"IV" = (
/obj/structure/window/reinforced{
	dir = 4;
	layer = 2.9
	},
/obj/structure/window/reinforced,
/obj/structure/window/reinforced{
	dir = 1;
	layer = 2.9
	},
/obj/structure/window/reinforced{
	dir = 8
	},
/obj/structure/flora/junglebush,
/obj/structure/flora/junglebush,
/obj/structure/flora/junglebush,
/turf/open/floor/grass,
/area/hilbertshotel)
"Jk" = (
/obj/machinery/vending/coffee{
	shut_up = 1
	},
/turf/open/floor/carpet/black,
/area/hilbertshotel)
"Jy" = (
/obj/structure/bed/double,
/turf/open/floor/carpet/royalblack,
/area/hilbertshotel)
"JK" = (
/obj/machinery/vending/boozeomat{
	onstation = 0;
	shut_up = 1
	},
/turf/closed/wall/mineral/brick,
/area/hilbertshotel)
"Lp" = (
/obj/item/newspaper{
	pixel_x = 4
	},
/turf/open/floor/carpet{
	icon_state = "carpetsymbol";
	dir = 1
	},
/area/hilbertshotel)
"Mo" = (
/obj/structure/mineral_door/wood,
/turf/open/floor/wood_common/wood_common_dark,
/area/hilbertshotel)
"MJ" = (
/obj/structure/table,
/obj/item/reagent_containers/syringe{
	pixel_x = -5;
	pixel_y = 14
	},
/turf/open/floor/pod/light,
/area/hilbertshotel)
"MR" = (
/obj/structure/sign/poster/contraband/random{
	pixel_x = 29
	},
/turf/open/floor/plasteel/cafeteria,
/area/hilbertshotel)
"Oc" = (
/obj/machinery/vending/kink{
	onstation = 0;
	shut_up = 1
	},
/obj/machinery/light{
	dir = 8;
	color = "#fc2847"
	},
/turf/open/floor/pod/light,
/area/hilbertshotel)
"Of" = (
/obj/structure/window/reinforced{
	dir = 8;
	layer = 2.9
	},
/obj/item/reagent_containers/food/drinks/beer,
/obj/item/reagent_containers/food/drinks/beer,
/obj/item/reagent_containers/food/drinks/beer,
/obj/item/reagent_containers/food/drinks/beer,
/obj/item/reagent_containers/food/drinks/beer,
/obj/item/reagent_containers/food/drinks/beer,
/obj/item/reagent_containers/food/condiment/flour,
/obj/structure/closet/secure_closet/freezer/fridge,
/turf/open/floor/plasteel/cafeteria,
/area/hilbertshotel)
"OE" = (
/obj/machinery/light{
	dir = 1
	},
/turf/open/floor/pod/dark,
/area/hilbertshotel)
"ON" = (
/obj/effect/turf_decal/siding/wood{
	dir = 5
	},
/turf/open/floor/carpet/royalblue,
/area/hilbertshotel)
"OY" = (
/obj/machinery/jukebox{
	req_one_access = null;
	area_limited = 1
	},
/obj/machinery/light{
	dir = 1
	},
/turf/open/floor/wood_common/wood_common_dark,
/area/hilbertshotel)
"PE" = (
/obj/structure/closet/crate/bin{
	pixel_x = -6
	},
/turf/open/floor/carpet/royalblack,
/area/hilbertshotel)
"PP" = (
/obj/machinery/button{
	pixel_y = -25;
	id = "elevator"
	},
/obj/machinery/button{
	pixel_y = -35;
	id = "elevator"
	},
/turf/open/floor/pod/dark,
/area/hilbertshotel)
"Ql" = (
/obj/structure/chair/sofa/corp/left{
	dir = 4
	},
/turf/open/floor/wood_common/wood_common_dark,
/area/hilbertshotel)
"Qt" = (
/obj/machinery/light,
/turf/open/floor/carpet/royalblack,
/area/hilbertshotel)
"Rb" = (
/obj/item/pizzabox/margherita{
	pixel_y = 11
	},
/obj/effect/turf_decal/siding/wood,
/obj/structure/table,
/turf/open/floor/carpet/royalblue,
/area/hilbertshotel)
"RP" = (
/obj/machinery/vending/cigarette{
	shut_up = 1
	},
/turf/open/floor/carpet/black,
/area/hilbertshotel)
"Si" = (
/obj/structure/dresser,
/turf/open/floor/carpet/royalblack,
/area/hilbertshotel)
"Sx" = (
/obj/structure/table/wood,
/obj/item/flashlight/lamp/green{
	pixel_x = 5;
	pixel_y = 14
	},
/turf/open/floor/carpet/royalblack,
/area/hilbertshotel)
"SG" = (
/obj/structure/table/wood,
/obj/item/choice_beacon/box/plushie,
/turf/open/floor/carpet/royalblack,
/area/hilbertshotel)
"SH" = (
/obj/item/kirbyplants/random,
/turf/open/floor/carpet/black,
/area/hilbertshotel)
"SZ" = (
/obj/structure/closet/crate/bin{
	pixel_x = 9
	},
/turf/open/floor/carpet/black,
/area/hilbertshotel)
"Ti" = (
/obj/structure/window/reinforced,
/obj/structure/window/reinforced{
	dir = 4
	},
/obj/structure/window/reinforced{
	dir = 1;
	layer = 2.9
	},
/obj/structure/flora/junglebush/large{
	pixel_y = -1
	},
/obj/structure/flora/junglebush,
/obj/structure/flora/junglebush,
/turf/open/floor/grass,
/area/hilbertshotel)
"Tw" = (
/obj/structure/chair/comfy/black{
	pixel_y = 6;
	dir = 1
	},
/obj/machinery/light,
/obj/effect/turf_decal/siding{
	dir = 4
	},
/turf/open/floor/wood_common/wood_common_dark,
/area/hilbertshotel)
"TE" = (
/obj/structure/closet/crate/bin{
	pixel_x = -6
	},
/obj/structure/sign/poster/contraband/random{
	pixel_x = -31
	},
/turf/open/floor/wood_common/wood_common_dark,
/area/hilbertshotel)
"TU" = (
/obj/structure/table,
/obj/item/lighter/gold,
/turf/open/floor/carpet/royalblue,
/area/hilbertshotel)
"Uh" = (
/obj/structure/chair/sofa/corp/corner{
	dir = 1
	},
/obj/machinery/light,
/turf/open/floor/wood_common/wood_common_dark,
/area/hilbertshotel)
"Ul" = (
/obj/effect/turf_decal/siding{
	dir = 4
	},
/turf/open/floor/wood_common/wood_common_dark,
/area/hilbertshotel)
"Vi" = (
/obj/effect/turf_decal/siding/wood{
	dir = 8
	},
/obj/structure/closet/crate/wooden,
/obj/item/clothing/shoes/sandal,
/obj/item/clothing/shoes/sandal,
/obj/item/clothing/shoes/sandal,
/obj/item/clothing/shoes/sandal,
/obj/item/clothing/shoes/sandal,
/obj/item/clothing/shoes/sandal,
/obj/item/clothing/shoes/sandal,
/turf/open/floor/wood_common/wood_common_dark,
/area/hilbertshotel)
"VY" = (
/obj/structure/table,
/obj/item/reagent_containers/blood/BPlus{
	pixel_x = 9
	},
/obj/item/reagent_containers/blood/BPlus{
	pixel_x = 9
	},
/obj/item/reagent_containers/blood/BPlus{
	pixel_x = 9
	},
/turf/open/floor/pod/light,
/area/hilbertshotel)
"Wp" = (
/obj/machinery/light{
	dir = 8
	},
/obj/machinery/vending/games{
	shut_up = 1
	},
/turf/open/floor/carpet/black,
/area/hilbertshotel)
"Wy" = (
/obj/effect/turf_decal/siding/wood{
	dir = 4
	},
/turf/open/floor/carpet/royalblue,
/area/hilbertshotel)
"XI" = (
/obj/structure/rack,
/turf/open/floor/carpet/red,
/area/hilbertshotel)
"Ym" = (
/obj/machinery/computer{
	dir = 4;
	pixel_x = -3
	},
/turf/open/floor/carpet/royalblack,
/area/hilbertshotel)
"ZG" = (
/obj/machinery/light{
	dir = 1
	},
/turf/open/floor/wood_common/wood_common_dark,
/area/hilbertshotel)

(1,1,1) = {"
sr
sr
sr
sr
sr
Ex
sr
sr
sr
sr
sr
sr
sr
sr
sr
sr
"}
(2,1,1) = {"
sr
HZ
xn
Oc
sr
kz
kz
PP
sr
SH
md
RP
Jk
Wp
sU
sr
"}
(3,1,1) = {"
sr
MJ
CD
id
sr
OE
kz
kz
eH
nF
nF
nF
nF
nF
sr
sr
"}
(4,1,1) = {"
sr
id
CD
VY
sr
kz
kz
kz
sr
Am
bI
SZ
Lp
nF
Gm
sr
"}
(5,1,1) = {"
sr
sr
jC
sr
sr
sr
sr
sr
sr
sr
sr
sr
gj
sr
sr
sr
"}
(6,1,1) = {"
sr
Ym
ry
PE
sr
IJ
fs
Ql
vP
Uh
sr
XI
fq
kg
sr
dQ
"}
(7,1,1) = {"
sr
dx
Fi
Qt
sr
ZG
tA
yc
Gk
rk
sr
Vi
bt
bt
sr
xt
"}
(8,1,1) = {"
sr
Si
Fi
Fi
gj
sp
tm
TU
Rb
lR
sr
EV
sp
sp
sr
xt
"}
(9,1,1) = {"
sr
Fi
Fi
Fi
sr
pu
tm
pH
Cf
sp
sr
IJ
sp
tQ
sr
xt
"}
(10,1,1) = {"
sr
Sx
Jy
SG
sr
OY
ON
Wy
ix
sp
sr
sr
Mo
sr
sr
xt
"}
(11,1,1) = {"
sr
sr
sr
sr
sr
sr
vv
ki
sp
sp
Ti
TE
sp
sp
sr
sr
"}
(12,1,1) = {"
sr
sp
Fh
nA
cV
sr
sr
sr
sp
sp
sp
sp
sp
sp
IJ
sr
"}
(13,1,1) = {"
sr
ww
oa
aq
EB
sr
Ft
sr
rj
Ul
Ul
Ul
Ul
Ul
Tw
sr
"}
(14,1,1) = {"
sr
aA
sp
yJ
sp
sr
tR
sr
sp
xp
IV
DR
cH
lq
Of
sr
"}
(15,1,1) = {"
sr
Gi
fr
sp
sp
tR
sp
sp
nH
sp
aY
Au
fB
MR
sV
sr
"}
(16,1,1) = {"
sr
sr
sr
sr
sr
sr
sr
sr
sr
sr
sr
JK
vZ
sr
sr
sr
"}
