//MAP CONVERTED BY dmm2tgm.py THIS HEADER COMMENT PREVENTS RECONVERSION, DO NOT REMOVE
"aN" = (
/obj/structure/dresser,
/turf/open/floor/carpet/red,
/area/hilbertshotel)
"bd" = (
/obj/effect/turf_decal/siding/wood{
	dir = 8
	},
/obj/structure/sign/painting/library{
	pixel_x = -32
	},
/turf/open/floor/carpet/royalblue,
/area/hilbertshotel)
"dm" = (
/obj/effect/turf_decal/trimline/white/filled/end{
	dir = 4
	},
/obj/effect/overlay/water{
	plane = -2;
	alpha = 140
	},
/obj/effect/overlay/water/top{
	alpha = 140
	},
/turf/open/water{
	icon = 'icons/turf/pool.dmi';
	icon_state = "pool_tile"
	},
/area/hilbertshotel)
"fb" = (
/obj/structure/table/wood,
/obj/item/pizzabox/margherita{
	pixel_y = 11
	},
/obj/effect/turf_decal/siding/wood{
	dir = 4
	},
/turf/open/floor/wood_common/wood_common_dark,
/area/hilbertshotel)
"fo" = (
/obj/effect/turf_decal/siding/wood{
	dir = 6
	},
/obj/machinery/light{
	dir = 4
	},
/turf/open/floor/carpet/royalblue,
/area/hilbertshotel)
"fy" = (
/obj/effect/turf_decal/siding/wood/corner{
	dir = 4
	},
/turf/open/floor/carpet/royalblue,
/area/hilbertshotel)
"fG" = (
/obj/machinery/light{
	dir = 1
	},
/obj/structure/spacevine{
	icon = 'icons/effects/effects.dmi';
	icon_state = "smoke";
	name = "steam";
	pixel_x = 19;
	plane = -2
	},
/obj/structure/spacevine{
	icon = 'icons/effects/effects.dmi';
	icon_state = "smoke";
	name = "steam";
	pixel_y = 12;
	pixel_x = 17;
	plane = -2
	},
/obj/structure/spacevine{
	icon = 'icons/effects/effects.dmi';
	icon_state = "smoke";
	name = "steam";
	plane = -2
	},
/obj/effect/overlay/fog/fog2{
	plane = -2
	},
/turf/open/floor/plasteel/white,
/area/hilbertshotel)
"fH" = (
/obj/effect/turf_decal/siding/wood/corner{
	dir = 8
	},
/turf/open/floor/carpet/royalblue,
/area/hilbertshotel)
"fW" = (
/obj/item/reagent_containers/rag/towel,
/turf/open/floor/plasteel/white,
/area/hilbertshotel)
"gP" = (
/obj/structure/table/glass,
/obj/structure/bedsheetbin/towel,
/obj/structure/spacevine{
	icon = 'icons/effects/effects.dmi';
	icon_state = "smoke";
	name = "steam";
	plane = -2
	},
/obj/effect/overlay/fog/fog2{
	plane = -2
	},
/turf/open/floor/plasteel/white,
/area/hilbertshotel)
"gS" = (
/obj/machinery/vending/games{
	shut_up = 1
	},
/obj/effect/turf_decal/siding/wood{
	dir = 1
	},
/turf/open/floor/carpet/royalblue,
/area/hilbertshotel)
"ix" = (
/obj/effect/turf_decal/siding/wood{
	dir = 8
	},
/obj/machinery/light{
	dir = 8;
	light_color = "#e8eaff"
	},
/turf/open/floor/carpet/royalblue,
/area/hilbertshotel)
"iJ" = (
/obj/effect/turf_decal/siding/wood{
	dir = 10
	},
/obj/structure/rack,
/obj/item/reagent_containers/rag/towel,
/obj/item/reagent_containers/rag/towel,
/obj/item/reagent_containers/rag/towel,
/obj/item/reagent_containers/rag/towel,
/obj/item/reagent_containers/rag/towel,
/obj/item/reagent_containers/rag/towel,
/obj/item/reagent_containers/rag/towel,
/obj/item/reagent_containers/rag/towel,
/turf/open/floor/carpet/royalblue,
/area/hilbertshotel)
"jr" = (
/obj/structure/sign/poster/contraband/random{
	pixel_x = -31
	},
/turf/open/floor/wood_common/wood_common_dark,
/area/hilbertshotel)
"jP" = (
/obj/structure/window/reinforced/tinted/frosted{
	dir = 1
	},
/obj/structure/chair/pew/right{
	dir = 4
	},
/obj/structure/spacevine{
	icon = 'icons/effects/effects.dmi';
	icon_state = "smoke";
	name = "steam";
	pixel_x = 19;
	plane = -2
	},
/obj/structure/spacevine{
	icon = 'icons/effects/effects.dmi';
	icon_state = "smoke";
	name = "steam";
	pixel_y = 12;
	pixel_x = 17;
	plane = -2
	},
/obj/structure/spacevine{
	icon = 'icons/effects/effects.dmi';
	icon_state = "smoke";
	name = "steam";
	plane = -2
	},
/obj/effect/overlay/fog/fog2{
	plane = -2
	},
/turf/open/floor/wood_common/wood_common_dark,
/area/hilbertshotel)
"jX" = (
/obj/structure/mineral_door/paperframe{
	name = "Changing Room";
	dir = 4
	},
/turf/open/floor/plasteel/white,
/area/hilbertshotel)
"kd" = (
/obj/structure/pool/Rboard,
/turf/open/floor/plasteel/white,
/area/hilbertshotel)
"ki" = (
/obj/structure/lattice,
/turf/open/space/bluespace,
/area/hilbertshotel)
"ly" = (
/obj/structure/closet/crate/wooden,
/obj/item/stack/sheet/mineral/wood/fifty,
/obj/item/lighter/gold,
/obj/item/wrench,
/turf/open/floor/carpet/red,
/area/hilbertshotel)
"mc" = (
/obj/machinery/pool/controller,
/obj/structure/railing{
	dir = 8
	},
/obj/machinery/light{
	dir = 4;
	light_color = "#c1caff"
	},
/turf/open/floor/plasteel/white,
/area/hilbertshotel)
"ne" = (
/obj/effect/turf_decal/siding/wood{
	dir = 9
	},
/turf/open/floor/carpet/royalblue,
/area/hilbertshotel)
"oz" = (
/obj/structure/railing{
	dir = 8
	},
/obj/structure/railing,
/turf/open/floor/plasteel/white,
/area/hilbertshotel)
"oR" = (
/obj/structure/closet/secure_closet/personal,
/obj/structure/window/reinforced/tinted/frosted{
	dir = 8
	},
/turf/open/floor/wood_common/wood_common_dark,
/area/hilbertshotel)
"pw" = (
/obj/structure/mineral_door/paperframe{
	name = "Changing Room";
	dir = 8
	},
/turf/open/floor/wood_common/wood_common_dark,
/area/hilbertshotel)
"pE" = (
/obj/effect/turf_decal/siding/wood{
	dir = 4
	},
/obj/structure/sign/painting/library{
	pixel_x = 32
	},
/turf/open/floor/carpet/royalblue,
/area/hilbertshotel)
"qi" = (
/obj/machinery/light/floor{
	bulb_colour = "F27D0C"
	},
/obj/structure/spacevine{
	icon = 'icons/effects/effects.dmi';
	icon_state = "smoke";
	name = "steam";
	pixel_x = 19;
	plane = -2
	},
/obj/structure/spacevine{
	icon = 'icons/effects/effects.dmi';
	icon_state = "smoke";
	name = "steam";
	pixel_y = 12;
	pixel_x = 17;
	plane = -2
	},
/obj/structure/spacevine{
	icon = 'icons/effects/effects.dmi';
	icon_state = "smoke";
	name = "steam";
	plane = -2
	},
/obj/effect/overlay/fog/fog2{
	plane = -2
	},
/turf/open/floor/wood_common/wood_common_dark,
/area/hilbertshotel)
"qm" = (
/obj/structure/table/wood,
/obj/item/storage/fancy/heart_box,
/obj/item/paper/fluff/hilbertshotel/welcomeletter,
/turf/open/floor/wood_common/wood_common_dark,
/area/hilbertshotel)
"qv" = (
/obj/structure/chair/pew/right{
	dir = 8
	},
/obj/structure/spacevine{
	icon = 'icons/effects/effects.dmi';
	icon_state = "smoke";
	name = "steam";
	plane = -2
	},
/obj/effect/overlay/fog/fog2{
	plane = -2
	},
/turf/open/floor/wood_common/wood_common_dark,
/area/hilbertshotel)
"rb" = (
/obj/effect/turf_decal/trimline/white/filled/line{
	dir = 8
	},
/obj/effect/overlay/water{
	plane = -2;
	alpha = 140
	},
/obj/effect/overlay/water/top{
	alpha = 140
	},
/turf/open/water{
	icon = 'icons/turf/pool.dmi';
	icon_state = "pool_tile"
	},
/area/hilbertshotel)
"rX" = (
/obj/structure/mineral_door/paperframe{
	name = "Changing Room";
	dir = 8
	},
/turf/open/floor/plasteel/white,
/area/hilbertshotel)
"tB" = (
/obj/machinery/light,
/turf/open/floor/wood_common/wood_common_dark,
/area/hilbertshotel)
"tF" = (
/obj/machinery/vending/boozeomat{
	onstation = 0;
	shut_up = 1
	},
/obj/effect/turf_decal/siding/wood{
	dir = 1
	},
/turf/open/floor/carpet/royalblue,
/area/hilbertshotel)
"tS" = (
/obj/structure/closet/athletic_mixed,
/obj/structure/window/reinforced/tinted/frosted{
	dir = 4
	},
/obj/structure/window/reinforced/tinted/frosted{
	dir = 8
	},
/turf/open/floor/wood_common/wood_common_dark,
/area/hilbertshotel)
"tX" = (
/obj/structure/closet/crate/wooden,
/obj/effect/turf_decal/siding/wood,
/obj/machinery/light,
/obj/item/clothing/shoes/sandal,
/obj/item/clothing/shoes/sandal,
/obj/item/clothing/shoes/sandal,
/obj/item/clothing/shoes/sandal,
/obj/item/clothing/shoes/sandal,
/obj/item/clothing/shoes/sandal,
/obj/item/clothing/shoes/sandal,
/turf/open/floor/carpet/royalblue,
/area/hilbertshotel)
"uG" = (
/obj/effect/turf_decal/siding/wood{
	dir = 4
	},
/turf/open/floor/wood_common/wood_common_dark,
/area/hilbertshotel)
"vL" = (
/obj/effect/turf_decal/siding/wood{
	dir = 1
	},
/turf/open/floor/carpet/royalblue,
/area/hilbertshotel)
"vN" = (
/obj/structure/pool/ladder{
	dir = 8;
	pixel_x = 4
	},
/obj/effect/turf_decal/trimline/white/filled/line{
	dir = 4
	},
/obj/effect/overlay/water{
	plane = -2;
	alpha = 140
	},
/obj/effect/overlay/water/top{
	alpha = 140
	},
/turf/open/water{
	icon = 'icons/turf/pool.dmi';
	icon_state = "pool_tile"
	},
/area/hilbertshotel)
"wy" = (
/obj/effect/turf_decal/siding/wood{
	dir = 4
	},
/obj/machinery/light{
	dir = 4
	},
/turf/open/floor/carpet/royalblue,
/area/hilbertshotel)
"wD" = (
/obj/structure/closet/cabinet,
/obj/effect/turf_decal/siding/wood{
	dir = 4
	},
/turf/open/floor/wood_common/wood_common_dark,
/area/hilbertshotel)
"xp" = (
/obj/effect/turf_decal/trimline/white/filled/line{
	dir = 9
	},
/obj/effect/overlay/water{
	plane = -2;
	alpha = 140
	},
/obj/effect/overlay/water/top{
	alpha = 140
	},
/turf/open/water{
	icon = 'icons/turf/pool.dmi';
	icon_state = "pool_tile"
	},
/area/hilbertshotel)
"xC" = (
/obj/effect/turf_decal/siding/wood{
	dir = 8
	},
/turf/open/floor/carpet/royalblue,
/area/hilbertshotel)
"xD" = (
/obj/effect/turf_decal/siding/wood,
/obj/structure/sign/painting/library{
	pixel_y = -32
	},
/turf/open/floor/carpet/royalblue,
/area/hilbertshotel)
"xE" = (
/obj/structure/spacevine{
	icon = 'icons/effects/effects.dmi';
	icon_state = "smoke";
	name = "steam";
	pixel_x = 19;
	plane = -2
	},
/obj/structure/spacevine{
	icon = 'icons/effects/effects.dmi';
	icon_state = "smoke";
	name = "steam";
	pixel_y = 12;
	pixel_x = 17;
	plane = -2
	},
/obj/structure/spacevine{
	icon = 'icons/effects/effects.dmi';
	icon_state = "smoke";
	name = "steam";
	plane = -2
	},
/obj/effect/overlay/fog/fog2{
	plane = -2
	},
/turf/open/floor/wood_common/wood_common_dark,
/area/hilbertshotel)
"zw" = (
/obj/effect/turf_decal/siding/wood{
	dir = 9
	},
/obj/item/kirbyplants/random,
/turf/open/floor/carpet/royalblue,
/area/hilbertshotel)
"zJ" = (
/turf/open/floor/plasteel/white,
/area/hilbertshotel)
"Aq" = (
/obj/structure/chair/pew/left{
	dir = 4
	},
/obj/structure/spacevine{
	icon = 'icons/effects/effects.dmi';
	icon_state = "smoke";
	name = "steam";
	pixel_x = 19;
	plane = -2
	},
/obj/structure/spacevine{
	icon = 'icons/effects/effects.dmi';
	icon_state = "smoke";
	name = "steam";
	pixel_y = 12;
	pixel_x = 17;
	plane = -2
	},
/obj/structure/spacevine{
	icon = 'icons/effects/effects.dmi';
	icon_state = "smoke";
	name = "steam";
	plane = -2
	},
/obj/effect/overlay/fog/fog2{
	plane = -2
	},
/turf/open/floor/wood_common/wood_common_dark,
/area/hilbertshotel)
"Au" = (
/obj/effect/turf_decal/siding/wood{
	dir = 6
	},
/turf/open/floor/carpet/royalblue,
/area/hilbertshotel)
"Bo" = (
/obj/structure/spacevine{
	icon = 'icons/effects/effects.dmi';
	icon_state = "smoke";
	name = "steam";
	pixel_x = 19;
	plane = -2
	},
/obj/structure/spacevine{
	icon = 'icons/effects/effects.dmi';
	icon_state = "smoke";
	name = "steam";
	pixel_y = 12;
	pixel_x = 17;
	plane = -2
	},
/obj/structure/spacevine{
	icon = 'icons/effects/effects.dmi';
	icon_state = "smoke";
	name = "steam";
	plane = -2
	},
/obj/effect/overlay/fog/fog2{
	plane = -2
	},
/turf/open/floor/plasteel/white,
/area/hilbertshotel)
"BQ" = (
/obj/effect/turf_decal/siding/wood{
	dir = 10
	},
/obj/machinery/vending/kink{
	onstation = 0;
	shut_up = 1
	},
/turf/open/floor/carpet/royalblue,
/area/hilbertshotel)
"CG" = (
/obj/effect/turf_decal/trimline/white/filled/line{
	dir = 4
	},
/obj/structure/pool/Lboard{
	plane = -1
	},
/obj/effect/overlay/water{
	plane = -2;
	alpha = 140
	},
/obj/effect/overlay/water/top{
	alpha = 140
	},
/turf/open/water{
	icon = 'icons/turf/pool.dmi';
	icon_state = "pool_tile"
	},
/area/hilbertshotel)
"CU" = (
/obj/effect/turf_decal/trimline/white/filled/line{
	dir = 8
	},
/obj/machinery/light{
	dir = 8;
	light_color = "#e8eaff"
	},
/obj/effect/overlay/water{
	plane = -2;
	alpha = 140
	},
/obj/effect/overlay/water/top{
	alpha = 140
	},
/turf/open/water{
	icon = 'icons/turf/pool.dmi';
	icon_state = "pool_tile"
	},
/area/hilbertshotel)
"CY" = (
/obj/machinery/vending/kink,
/turf/open/floor/wood_common/wood_common_dark,
/area/hilbertshotel)
"CZ" = (
/obj/structure/fireplace{
	pixel_x = 0
	},
/turf/open/floor/carpet/red,
/area/hilbertshotel)
"Dt" = (
/obj/structure/chair/pew{
	dir = 4
	},
/obj/structure/spacevine{
	icon = 'icons/effects/effects.dmi';
	icon_state = "smoke";
	name = "steam";
	pixel_x = 19;
	plane = -2
	},
/obj/structure/spacevine{
	icon = 'icons/effects/effects.dmi';
	icon_state = "smoke";
	name = "steam";
	pixel_y = 12;
	pixel_x = 17;
	plane = -2
	},
/obj/structure/spacevine{
	icon = 'icons/effects/effects.dmi';
	icon_state = "smoke";
	name = "steam";
	plane = -2
	},
/obj/effect/overlay/fog/fog2{
	plane = -2
	},
/turf/open/floor/wood_common/wood_common_dark,
/area/hilbertshotel)
"DO" = (
/obj/structure/table,
/obj/machinery/light{
	dir = 4;
	light_color = "#c1caff"
	},
/turf/open/floor/plasteel/white,
/area/hilbertshotel)
"EW" = (
/obj/structure/window/reinforced/tinted/frosted{
	dir = 1
	},
/obj/structure/chair/pew/left{
	dir = 8
	},
/obj/structure/spacevine{
	icon = 'icons/effects/effects.dmi';
	icon_state = "smoke";
	name = "steam";
	plane = -2
	},
/obj/effect/overlay/fog/fog2{
	plane = -2
	},
/turf/open/floor/wood_common/wood_common_dark,
/area/hilbertshotel)
"FQ" = (
/turf/closed/wall/mineral/wood,
/area/hilbertshotel)
"Gm" = (
/obj/machinery/shower{
	pixel_y = 16
	},
/obj/structure/spacevine{
	icon = 'icons/effects/effects.dmi';
	icon_state = "smoke";
	name = "steam";
	pixel_x = 19;
	plane = -2
	},
/obj/structure/spacevine{
	icon = 'icons/effects/effects.dmi';
	icon_state = "smoke";
	name = "steam";
	pixel_y = 12;
	pixel_x = 17;
	plane = -2
	},
/obj/structure/spacevine{
	icon = 'icons/effects/effects.dmi';
	icon_state = "smoke";
	name = "steam";
	plane = -2
	},
/obj/effect/overlay/fog/fog2{
	plane = -2
	},
/turf/open/floor/plasteel/white,
/area/hilbertshotel)
"Gs" = (
/obj/effect/turf_decal/trimline/white/filled/line{
	dir = 10
	},
/obj/effect/overlay/water{
	plane = -2;
	alpha = 140
	},
/obj/effect/overlay/water/top{
	alpha = 140
	},
/turf/open/water{
	icon = 'icons/turf/pool.dmi';
	icon_state = "pool_tile"
	},
/area/hilbertshotel)
"Gw" = (
/obj/effect/turf_decal/trimline/white/filled/line{
	dir = 4
	},
/obj/effect/overlay/water{
	plane = -2;
	alpha = 140
	},
/obj/effect/overlay/water/top{
	alpha = 140
	},
/turf/open/water{
	icon = 'icons/turf/pool.dmi';
	icon_state = "pool_tile"
	},
/area/hilbertshotel)
"GJ" = (
/turf/closed/indestructible/hoteldoor{
	icon_state = "door_closed";
	icon = 'icons/obj/doors/puzzledoor/default.dmi'
	},
/area/hilbertshotel)
"HB" = (
/obj/machinery/smartfridge/drinks,
/turf/closed/wall/mineral/wood,
/area/hilbertshotel)
"HN" = (
/obj/structure/table/glass,
/obj/machinery/light{
	dir = 4;
	light_color = "#c1caff"
	},
/turf/open/floor/plasteel/white,
/area/hilbertshotel)
"Kq" = (
/obj/effect/turf_decal/trimline/white/filled/line,
/obj/effect/turf_decal/trimline/white/filled/corner{
	dir = 4
	},
/obj/effect/overlay/water{
	plane = -2;
	alpha = 140
	},
/obj/effect/overlay/water/top{
	alpha = 140
	},
/turf/open/water{
	icon = 'icons/turf/pool.dmi';
	icon_state = "pool_tile"
	},
/area/hilbertshotel)
"Kt" = (
/obj/structure/falsewall/wood,
/turf/open/indestructible/ground/outside/desert,
/area/hilbertshotel)
"Kz" = (
/obj/structure/rack,
/obj/item/toy/poolnoodle/blue,
/obj/item/toy/poolnoodle/blue,
/obj/item/toy/poolnoodle/blue,
/turf/open/floor/wood_common/wood_common_dark,
/area/hilbertshotel)
"KL" = (
/obj/structure/closet/secure_closet/personal,
/obj/structure/window/reinforced/tinted/frosted{
	dir = 4
	},
/obj/structure/window/reinforced/tinted/frosted{
	dir = 8
	},
/turf/open/floor/wood_common/wood_common_dark,
/area/hilbertshotel)
"LP" = (
/obj/machinery/vending/cigarette{
	shut_up = 1
	},
/obj/effect/turf_decal/siding/wood{
	dir = 1
	},
/turf/open/floor/carpet/royalblue,
/area/hilbertshotel)
"Ml" = (
/obj/structure/sign/poster/contraband/random{
	pixel_x = 29
	},
/obj/structure/bed/double,
/turf/open/floor/carpet/red,
/area/hilbertshotel)
"MT" = (
/obj/machinery/jukebox{
	req_one_access = null;
	area_limited = 1
	},
/turf/open/floor/carpet/red,
/area/hilbertshotel)
"NC" = (
/obj/structure/table/wood,
/obj/item/flashlight/lamp/green{
	pixel_x = 5;
	pixel_y = 3
	},
/obj/item/choice_beacon/box/plushie,
/turf/open/floor/carpet/red,
/area/hilbertshotel)
"ND" = (
/obj/effect/turf_decal/siding/wood/corner{
	dir = 1
	},
/turf/open/floor/carpet/royalblue,
/area/hilbertshotel)
"NG" = (
/obj/structure/window/reinforced/tinted/frosted{
	dir = 1
	},
/obj/structure/spacevine{
	icon = 'icons/effects/effects.dmi';
	icon_state = "smoke";
	name = "steam";
	pixel_x = 19;
	plane = -2
	},
/obj/structure/spacevine{
	icon = 'icons/effects/effects.dmi';
	icon_state = "smoke";
	name = "steam";
	pixel_y = 12;
	pixel_x = 17;
	plane = -2
	},
/obj/structure/spacevine{
	icon = 'icons/effects/effects.dmi';
	icon_state = "smoke";
	name = "steam";
	plane = -2
	},
/obj/effect/overlay/fog/fog2{
	plane = -2
	},
/turf/open/floor/wood_common/wood_common_dark,
/area/hilbertshotel)
"Op" = (
/obj/structure/closet/crate/bin{
	pixel_x = 9
	},
/obj/effect/turf_decal/siding/wood{
	dir = 1
	},
/turf/open/floor/carpet/royalblue,
/area/hilbertshotel)
"OQ" = (
/obj/effect/turf_decal/trimline/white/filled/line{
	dir = 8
	},
/obj/machinery/shower{
	desc = "Despite their age, they seem clean and capable of providing hot water just as well as their modern counterparts. Hopefully Nanotrasen cleaned the water pipes this well...";
	dir = 4
	},
/obj/effect/overlay/water{
	plane = -2;
	alpha = 140
	},
/obj/effect/overlay/water/top{
	alpha = 140
	},
/turf/open/water{
	icon = 'icons/turf/pool.dmi';
	icon_state = "pool_tile"
	},
/area/hilbertshotel)
"OW" = (
/obj/effect/turf_decal/siding/wood{
	dir = 5
	},
/obj/structure/closet/crate/bin{
	pixel_x = -2
	},
/turf/open/floor/carpet/royalblue,
/area/hilbertshotel)
"OY" = (
/obj/effect/overlay/water{
	plane = -2;
	alpha = 140
	},
/obj/effect/overlay/water/top{
	alpha = 140
	},
/turf/open/water{
	icon = 'icons/turf/pool.dmi';
	icon_state = "pool_tile"
	},
/area/hilbertshotel)
"Ph" = (
/obj/machinery/vending/dinnerware{
	contraband = list(/obj/item/kitchen/rollingpin=2,/obj/item/kitchen/knife/butcher=2,/obj/item/reagent_containers/food/condiment/flour=4);
	shut_up = 1
	},
/obj/effect/turf_decal/siding/wood{
	dir = 5
	},
/turf/open/floor/carpet/royalblue,
/area/hilbertshotel)
"Pn" = (
/obj/effect/turf_decal/siding/wood{
	dir = 4
	},
/turf/open/floor/carpet/royalblue,
/area/hilbertshotel)
"PD" = (
/turf/open/floor/carpet/red,
/area/hilbertshotel)
"QM" = (
/obj/effect/turf_decal/siding/wood/corner,
/turf/open/floor/carpet/royalblue,
/area/hilbertshotel)
"QS" = (
/obj/structure/railing{
	dir = 8
	},
/obj/structure/table,
/obj/structure/bedsheetbin/towel,
/turf/open/floor/plasteel/white,
/area/hilbertshotel)
"Rt" = (
/obj/structure/rack,
/turf/open/floor/wood_common/wood_common_dark,
/area/hilbertshotel)
"Rz" = (
/obj/effect/turf_decal/trimline/white/filled/line,
/obj/effect/overlay/water{
	plane = -2;
	alpha = 140
	},
/obj/effect/overlay/water/top{
	alpha = 140
	},
/turf/open/water{
	icon = 'icons/turf/pool.dmi';
	icon_state = "pool_tile"
	},
/area/hilbertshotel)
"RY" = (
/obj/structure/railing{
	dir = 8
	},
/turf/open/floor/plasteel/white,
/area/hilbertshotel)
"Si" = (
/obj/machinery/telecomms/relay/preset/auto,
/area/hilbertshotel)
"Sv" = (
/obj/effect/turf_decal/trimline/white/filled/line{
	dir = 1
	},
/obj/effect/overlay/water{
	plane = -2;
	alpha = 140
	},
/obj/effect/overlay/water/top{
	alpha = 140
	},
/turf/open/water{
	icon = 'icons/turf/pool.dmi';
	icon_state = "pool_tile"
	},
/area/hilbertshotel)
"Sx" = (
/turf/open/floor/wood_common/wood_common_dark,
/area/hilbertshotel)
"Tp" = (
/obj/structure/reagent_dispensers/watertank,
/obj/structure/spacevine{
	icon = 'icons/effects/effects.dmi';
	icon_state = "smoke";
	name = "steam";
	plane = -2
	},
/obj/effect/overlay/fog/fog2{
	plane = -2
	},
/turf/open/floor/plasteel/white,
/area/hilbertshotel)
"TH" = (
/obj/structure/mineral_door/paperframe{
	name = "Changing Room";
	dir = 4
	},
/turf/open/floor/wood_common/wood_common_dark,
/area/hilbertshotel)
"Ur" = (
/obj/structure/closet/athletic_mixed,
/obj/structure/window/reinforced/tinted/frosted{
	dir = 4
	},
/turf/open/floor/wood_common/wood_common_dark,
/area/hilbertshotel)
"UJ" = (
/obj/structure/closet/crate/wooden,
/obj/item/stack/sheet/mineral/wood/fifty,
/obj/item/reagent_containers/glass/bucket{
	pixel_y = 7
	},
/obj/structure/spacevine{
	icon = 'icons/effects/effects.dmi';
	icon_state = "smoke";
	name = "steam";
	plane = -2
	},
/obj/effect/overlay/fog/fog2{
	plane = -2
	},
/turf/open/floor/plasteel/white,
/area/hilbertshotel)
"UR" = (
/obj/effect/turf_decal/siding/wood{
	dir = 1
	},
/obj/item/kirbyplants/random,
/turf/open/floor/carpet/royalblue,
/area/hilbertshotel)
"Vk" = (
/obj/structure/table/wood,
/obj/structure/spacevine{
	icon = 'icons/effects/effects.dmi';
	icon_state = "smoke";
	name = "steam";
	pixel_x = 19;
	plane = -2
	},
/obj/structure/spacevine{
	icon = 'icons/effects/effects.dmi';
	icon_state = "smoke";
	name = "steam";
	pixel_y = 12;
	pixel_x = 17;
	plane = -2
	},
/obj/structure/spacevine{
	icon = 'icons/effects/effects.dmi';
	icon_state = "smoke";
	name = "steam";
	plane = -2
	},
/obj/effect/overlay/fog/fog2{
	plane = -2
	},
/turf/open/floor/wood_common/wood_common_dark,
/area/hilbertshotel)
"Wj" = (
/obj/structure/chair/pew{
	dir = 8
	},
/obj/structure/spacevine{
	icon = 'icons/effects/effects.dmi';
	icon_state = "smoke";
	name = "steam";
	plane = -2
	},
/obj/effect/overlay/fog/fog2{
	plane = -2
	},
/turf/open/floor/wood_common/wood_common_dark,
/area/hilbertshotel)
"XH" = (
/obj/effect/turf_decal/siding/wood,
/obj/machinery/light,
/turf/open/floor/carpet/royalblue,
/area/hilbertshotel)
"Ym" = (
/obj/effect/turf_decal/trimline/white/filled/line{
	dir = 5
	},
/obj/effect/overlay/water{
	plane = -2;
	alpha = 140
	},
/obj/effect/overlay/water/top{
	alpha = 140
	},
/turf/open/water{
	icon = 'icons/turf/pool.dmi';
	icon_state = "pool_tile"
	},
/area/hilbertshotel)
"Zm" = (
/obj/effect/turf_decal/siding/wood,
/turf/open/floor/carpet/royalblue,
/area/hilbertshotel)

(1,1,1) = {"
FQ
FQ
FQ
FQ
FQ
GJ
FQ
FQ
FQ
FQ
FQ
HB
FQ
FQ
FQ
FQ
"}
(2,1,1) = {"
FQ
Ur
jr
Kz
FQ
ne
iJ
FQ
xp
CU
OQ
rb
OQ
CU
Gs
FQ
"}
(3,1,1) = {"
FQ
tS
Sx
Sx
FQ
vL
Zm
FQ
Sv
OY
OY
OY
OY
OY
Rz
FQ
"}
(4,1,1) = {"
FQ
KL
Sx
tB
FQ
vL
tX
FQ
Ym
CG
vN
Gw
Gw
Gw
Kq
FQ
"}
(5,1,1) = {"
FQ
KL
Sx
Sx
FQ
vL
Zm
FQ
QS
kd
zJ
RY
RY
oz
dm
FQ
"}
(6,1,1) = {"
FQ
oR
Sx
CY
FQ
vL
Zm
FQ
DO
zJ
fW
HN
fW
zJ
mc
FQ
"}
(7,1,1) = {"
FQ
FQ
pw
FQ
FQ
vL
xD
FQ
FQ
rX
FQ
FQ
FQ
FQ
FQ
FQ
"}
(8,1,1) = {"
FQ
zw
xC
xC
ix
ND
fH
xC
xC
xC
xC
bd
xC
Kt
BQ
FQ
"}
(9,1,1) = {"
FQ
OW
Pn
pE
Pn
fy
QM
wy
Pn
Pn
Pn
wy
Pn
Kt
fo
FQ
"}
(10,1,1) = {"
FQ
FQ
TH
FQ
FQ
UR
Zm
FQ
FQ
jX
FQ
FQ
FQ
FQ
FQ
FQ
"}
(11,1,1) = {"
FQ
Rt
Sx
qm
FQ
Op
Zm
FQ
Bo
Bo
Bo
jP
Dt
Aq
FQ
Si
"}
(12,1,1) = {"
FQ
wD
uG
fb
FQ
LP
Zm
FQ
Gm
Bo
Bo
NG
xE
Vk
FQ
ki
"}
(13,1,1) = {"
FQ
CZ
PD
ly
FQ
gS
XH
FQ
fG
Bo
Bo
xE
qi
xE
FQ
ki
"}
(14,1,1) = {"
FQ
PD
PD
MT
FQ
tF
Zm
FQ
Gm
Bo
Bo
NG
xE
Vk
FQ
ki
"}
(15,1,1) = {"
FQ
aN
Ml
NC
FQ
Ph
Au
FQ
gP
UJ
Tp
EW
Wj
qv
FQ
ki
"}
(16,1,1) = {"
FQ
FQ
FQ
FQ
FQ
FQ
FQ
FQ
FQ
FQ
FQ
FQ
FQ
FQ
FQ
FQ
"}
