//MAP CONVERTED BY dmm2tgm.py THIS HEADER COMMENT PREVENTS RECONVERSION, DO NOT REMOVE
"cK" = (
/turf/open/floor/carpet/black,
/area/hilbertshotel)
"dy" = (
/obj/structure/chair/stool/bar,
/turf/open/floor/carpet/black,
/area/hilbertshotel)
"dR" = (
/obj/effect/turf_decal/siding/wood{
	dir = 1
	},
/obj/structure/table/wood/fancy/royalblack,
/obj/item/storage/fancy/heart_box,
/obj/item/paper/fluff/hilbertshotel/welcomeletter,
/turf/open/floor/wood_common/wood_common_dark,
/area/hilbertshotel)
"ee" = (
/turf/open/floor/carpet/royalblack,
/area/hilbertshotel)
"fo" = (
/obj/machinery/vending/boozeomat{
	shut_up = 1
	},
/turf/open/floor/wood_common/wood_common_dark,
/area/hilbertshotel)
"hi" = (
/obj/structure/chair/stool/bar{
	dir = 1
	},
/turf/open/floor/carpet/royalblack,
/area/hilbertshotel)
"jj" = (
/obj/structure/mirror,
/turf/closed/wall/mineral/brick,
/area/hilbertshotel)
"kp" = (
/obj/structure/table/wood,
/obj/machinery/light{
	dir = 4
	},
/turf/open/floor/carpet/royalblack,
/area/hilbertshotel)
"kr" = (
/obj/effect/turf_decal/siding/wood,
/obj/structure/chair/stool/bar{
	dir = 1
	},
/turf/open/floor/carpet/royalblack,
/area/hilbertshotel)
"kB" = (
/obj/item/toy/cards/deck,
/obj/structure/table/wood/fancy/royalblack,
/turf/open/floor/carpet/royalblack,
/area/hilbertshotel)
"kC" = (
/obj/structure/table/wood,
/obj/machinery/light{
	dir = 4
	},
/obj/structure/sign/poster/contraband/random{
	pixel_x = 32
	},
/turf/open/floor/carpet/royalblack,
/area/hilbertshotel)
"kQ" = (
/turf/closed/indestructible/hoteldoor{
	icon_state = "door_closed";
	icon = 'icons/obj/doors/puzzledoor/default.dmi'
	},
/area/hilbertshotel)
"li" = (
/obj/structure/table/wood,
/obj/item/reagent_containers/food/drinks/shaker{
	pixel_x = 1;
	pixel_y = 13
	},
/obj/item/reagent_containers/food/drinks/shaker{
	pixel_x = -9
	},
/obj/item/reagent_containers/food/drinks/drinkingglass,
/obj/item/reagent_containers/food/drinks/drinkingglass,
/obj/item/reagent_containers/food/drinks/drinkingglass,
/obj/item/reagent_containers/food/drinks/drinkingglass,
/obj/item/reagent_containers/food/drinks/drinkingglass,
/turf/open/floor/wood_common/wood_common_dark,
/area/hilbertshotel)
"lS" = (
/obj/structure/table/wood,
/obj/machinery/chem_dispenser/drinks{
	dir = 1
	},
/turf/open/floor/wood_common/wood_common_dark,
/area/hilbertshotel)
"nj" = (
/obj/effect/turf_decal/siding/wood,
/obj/structure/table/wood/fancy/royalblack,
/turf/open/floor/carpet/royalblack,
/area/hilbertshotel)
"nQ" = (
/obj/effect/turf_decal/siding/wood{
	dir = 1
	},
/obj/structure/table/wood/fancy/royalblack,
/turf/open/floor/wood_common/wood_common_dark,
/area/hilbertshotel)
"oH" = (
/obj/structure/table/wood,
/obj/machinery/chem_dispenser/drinks/beer{
	dir = 1
	},
/turf/open/floor/wood_common/wood_common_dark,
/area/hilbertshotel)
"pr" = (
/obj/structure/chair/stool/bar,
/turf/open/floor/carpet/royalblack,
/area/hilbertshotel)
"qn" = (
/obj/machinery/light{
	dir = 1
	},
/turf/open/floor/carpet/royalblack,
/area/hilbertshotel)
"qQ" = (
/obj/structure/table/wood/fancy/royalblack,
/turf/open/floor/carpet/royalblack,
/area/hilbertshotel)
"rY" = (
/obj/structure/sign/poster/random,
/turf/closed/wall/mineral/brick,
/area/hilbertshotel)
"sm" = (
/obj/effect/turf_decal/siding/wood,
/turf/open/floor/carpet/royalblack,
/area/hilbertshotel)
"sU" = (
/obj/structure/sink{
	pixel_y = 24
	},
/obj/structure/urinal{
	dir = 8;
	pixel_x = 32
	},
/turf/open/indestructible/hoteltile,
/area/hilbertshotel)
"sY" = (
/obj/structure/table/wood,
/obj/effect/turf_decal/siding/wood{
	dir = 8
	},
/turf/open/floor/carpet/royalblack,
/area/hilbertshotel)
"te" = (
/obj/machinery/door/morgue,
/turf/open/indestructible/hoteltile,
/area/hilbertshotel)
"tl" = (
/obj/structure/sink{
	pixel_y = 24
	},
/obj/structure/urinal{
	dir = 4;
	pixel_x = -32
	},
/turf/open/indestructible/hoteltile,
/area/hilbertshotel)
"tx" = (
/obj/machinery/door/window/survival_pod{
	dir = 4
	},
/turf/open/floor/carpet/royalblack,
/area/hilbertshotel)
"ut" = (
/obj/structure/window{
	dir = 1;
	icon_state = "window"
	},
/obj/effect/turf_decal/siding/wood{
	dir = 8
	},
/obj/structure/chair/sofa/corp/right{
	color = "#DE3A3A"
	},
/turf/open/floor/carpet/royalblack,
/area/hilbertshotel)
"vU" = (
/obj/machinery/telecomms/relay/preset/auto,
/area/hilbertshotel)
"vW" = (
/obj/structure/table/wood,
/turf/open/floor/carpet/royalblack,
/area/hilbertshotel)
"wB" = (
/obj/machinery/computer/slot_machine,
/turf/open/floor/carpet/royalblack,
/area/hilbertshotel)
"xI" = (
/obj/structure/window{
	dir = 1;
	icon_state = "window"
	},
/obj/structure/chair/sofa/corp{
	color = "#DE3A3A"
	},
/turf/open/floor/carpet/royalblack,
/area/hilbertshotel)
"yz" = (
/turf/open/floor/wood_common/wood_common_dark,
/area/hilbertshotel)
"yO" = (
/obj/effect/turf_decal/siding/wood,
/obj/item/choice_beacon/box/plushie,
/obj/structure/table/wood/fancy/royalblack,
/turf/open/floor/carpet/royalblack,
/area/hilbertshotel)
"BL" = (
/obj/machinery/light{
	dir = 8
	},
/turf/open/indestructible/hoteltile,
/area/hilbertshotel)
"CL" = (
/obj/effect/turf_decal/siding/wood{
	dir = 4
	},
/obj/structure/window/reinforced/survival_pod{
	dir = 4
	},
/turf/open/floor/wood_common/wood_common_dark,
/area/hilbertshotel)
"DV" = (
/obj/machinery/light{
	dir = 1
	},
/obj/structure/toilet,
/turf/open/indestructible/hoteltile,
/area/hilbertshotel)
"EI" = (
/obj/effect/turf_decal/siding/wood{
	dir = 4
	},
/obj/effect/turf_decal/siding/wood{
	dir = 1
	},
/obj/structure/table/wood/fancy/royalblack,
/turf/open/floor/wood_common/wood_common_dark,
/area/hilbertshotel)
"Fz" = (
/obj/structure/window{
	dir = 1;
	icon_state = "window"
	},
/obj/structure/chair/sofa/corp/left{
	color = "#DE3A3A"
	},
/turf/open/floor/carpet/royalblack,
/area/hilbertshotel)
"FA" = (
/obj/structure/window{
	dir = 1
	},
/obj/effect/turf_decal/siding/wood{
	dir = 8
	},
/obj/structure/chair/sofa/corp/right{
	color = "#DE3A3A"
	},
/turf/open/floor/carpet/royalblack,
/area/hilbertshotel)
"GV" = (
/turf/open/indestructible/hoteltile,
/area/hilbertshotel)
"Hs" = (
/obj/structure/window,
/obj/structure/chair/sofa/corp/left{
	color = "#DE3A3A";
	dir = 1
	},
/obj/effect/turf_decal/siding/wood{
	dir = 8
	},
/turf/open/floor/carpet/royalblack,
/area/hilbertshotel)
"Hy" = (
/obj/structure/window,
/obj/structure/chair/sofa/corp/right{
	color = "#DE3A3A";
	dir = 1
	},
/turf/open/floor/carpet/royalblack,
/area/hilbertshotel)
"Ik" = (
/obj/structure/window{
	dir = 1
	},
/obj/structure/chair/sofa/corp{
	color = "#DE3A3A"
	},
/turf/open/floor/carpet/royalblack,
/area/hilbertshotel)
"Ji" = (
/obj/machinery/jukebox/disco{
	anchored = 1;
	req_one_access = null;
	area_limited = 1
	},
/turf/open/floor/carpet/black,
/area/hilbertshotel)
"Mr" = (
/obj/machinery/light{
	dir = 1
	},
/obj/machinery/vending/games{
	shut_up = 1
	},
/turf/open/floor/carpet/black,
/area/hilbertshotel)
"Mz" = (
/obj/structure/window{
	dir = 1
	},
/obj/structure/chair/sofa/corp/left{
	color = "#DE3A3A"
	},
/turf/open/floor/carpet/royalblack,
/area/hilbertshotel)
"MV" = (
/turf/closed/wall,
/area/hilbertshotel)
"OA" = (
/obj/structure/chair/sofa/corp/right{
	color = "#DE3A3A";
	dir = 1
	},
/turf/open/floor/carpet/royalblack,
/area/hilbertshotel)
"Pz" = (
/obj/structure/sink/kitchen{
	dir = 4;
	pixel_x = -14
	},
/turf/open/floor/wood_common/wood_common_dark,
/area/hilbertshotel)
"PG" = (
/obj/machinery/smartfridge/drinks,
/turf/closed/wall/mineral/brick,
/area/hilbertshotel)
"PJ" = (
/obj/structure/window,
/obj/structure/chair/sofa/corp{
	color = "#DE3A3A";
	dir = 1
	},
/turf/open/floor/carpet/royalblack,
/area/hilbertshotel)
"QC" = (
/obj/structure/sign/poster/contraband/random,
/turf/closed/wall,
/area/hilbertshotel)
"QE" = (
/obj/effect/turf_decal/siding/wood{
	dir = 4
	},
/obj/machinery/door/window/survival_pod{
	dir = 4
	},
/obj/machinery/light,
/turf/open/floor/wood_common/wood_common_dark,
/area/hilbertshotel)
"RL" = (
/obj/structure/lattice,
/turf/open/space/bluespace,
/area/hilbertshotel)
"SW" = (
/obj/structure/sign/poster/contraband/random,
/turf/closed/wall/mineral/brick,
/area/hilbertshotel)
"Tk" = (
/obj/structure/table,
/obj/structure/bedsheetbin,
/turf/open/indestructible/hoteltile,
/area/hilbertshotel)
"Tx" = (
/obj/structure/chair/sofa/corp{
	color = "#DE3A3A";
	dir = 1
	},
/turf/open/floor/carpet/royalblack,
/area/hilbertshotel)
"TA" = (
/obj/machinery/light{
	dir = 8
	},
/turf/open/floor/wood_common/wood_common_dark,
/area/hilbertshotel)
"UR" = (
/obj/effect/turf_decal/siding/wood{
	dir = 4
	},
/obj/structure/window/reinforced/survival_pod{
	dir = 4
	},
/obj/structure/table/wood/fancy/royalblack,
/turf/open/floor/wood_common/wood_common_dark,
/area/hilbertshotel)
"We" = (
/obj/machinery/vending/snack/random,
/turf/open/floor/carpet/black,
/area/hilbertshotel)
"Wg" = (
/obj/machinery/light{
	dir = 8
	},
/turf/open/floor/carpet/black,
/area/hilbertshotel)
"WO" = (
/obj/structure/table,
/turf/open/indestructible/hoteltile,
/area/hilbertshotel)
"Xr" = (
/turf/open/space/bluespace,
/area/hilbertshotel)
"Zn" = (
/obj/structure/chair/sofa/corp/left{
	color = "#DE3A3A";
	dir = 1
	},
/obj/effect/turf_decal/siding/wood{
	dir = 8
	},
/turf/open/floor/carpet/royalblack,
/area/hilbertshotel)
"ZE" = (
/turf/closed/wall/mineral/brick,
/area/hilbertshotel)

(1,1,1) = {"
Xr
Xr
Xr
Xr
Xr
Xr
Xr
Xr
Xr
Xr
Xr
Xr
Xr
Xr
Xr
Xr
"}
(2,1,1) = {"
Xr
Xr
ZE
ZE
SW
ZE
ZE
ZE
kQ
ZE
ZE
rY
ZE
SW
ZE
Xr
"}
(3,1,1) = {"
Xr
vU
rY
ee
ee
pr
yO
Wg
yz
dy
nQ
TA
Pz
li
ZE
Xr
"}
(4,1,1) = {"
Xr
RL
ZE
tx
kB
qQ
nj
cK
yz
dy
nQ
yz
yz
lS
ZE
Xr
"}
(5,1,1) = {"
Xr
RL
SW
qn
hi
hi
kr
cK
yz
dy
dR
yz
yz
oH
rY
Xr
"}
(6,1,1) = {"
Xr
RL
ZE
ee
ee
ee
sm
cK
yz
dy
nQ
yz
yz
fo
ZE
Xr
"}
(7,1,1) = {"
Xr
RL
rY
wB
hi
ee
sm
cK
yz
dy
nQ
yz
yz
yz
PG
Xr
"}
(8,1,1) = {"
Xr
Xr
ZE
ZE
ZE
ZE
ZE
Ji
yz
dy
EI
UR
CL
QE
rY
Xr
"}
(9,1,1) = {"
Xr
Xr
jj
tl
BL
GV
te
cK
yz
cK
cK
cK
cK
cK
ZE
Xr
"}
(10,1,1) = {"
Xr
Xr
jj
sU
GV
GV
ZE
Mr
yz
yz
yz
yz
yz
yz
ZE
Xr
"}
(11,1,1) = {"
Xr
Xr
ZE
MV
QC
GV
ZE
We
cK
cK
cK
cK
cK
cK
ZE
Xr
"}
(12,1,1) = {"
Xr
Xr
ZE
DV
te
GV
ZE
rY
ut
sY
Hs
FA
sY
Zn
SW
Xr
"}
(13,1,1) = {"
Xr
Xr
ZE
MV
MV
GV
Tk
ZE
xI
vW
PJ
Ik
vW
Tx
ZE
Xr
"}
(14,1,1) = {"
Xr
Xr
ZE
DV
te
GV
WO
SW
Fz
kp
Hy
Mz
kC
OA
rY
Xr
"}
(15,1,1) = {"
Xr
Xr
ZE
ZE
ZE
rY
ZE
ZE
ZE
rY
ZE
ZE
ZE
ZE
ZE
Xr
"}
(16,1,1) = {"
Xr
Xr
Xr
Xr
Xr
Xr
Xr
Xr
Xr
Xr
Xr
Xr
Xr
Xr
Xr
Xr
"}
