//MAP CONVERTED BY dmm2tgm.py THIS HEADER COMMENT PREVENTS RECONVERSION, DO NOT REMOVE
"af" = (
/obj/structure/spacevine,
/obj/structure/flora/ausbushes/brflowers,
/turf/closed/indestructible/wood,
/area/hilbertshotel)
"aA" = (
/obj/structure/flora/ausbushes/sparsegrass,
/obj/machinery/light/floor,
/turf/open/floor/grass,
/area/hilbertshotel)
"bg" = (
/obj/structure/spacevine,
/obj/structure/flora/ausbushes/ppflowers,
/turf/closed/indestructible/wood,
/area/hilbertshotel)
"dn" = (
/obj/structure/chair/pew{
	dir = 1
	},
/turf/open/floor/grass,
/area/hilbertshotel)
"fz" = (
/obj/machinery/telecomms/relay/preset/auto,
/area/hilbertshotel)
"ga" = (
/obj/structure/flora/ausbushes/sparsegrass,
/obj/structure/flora/ausbushes/ppflowers,
/turf/open/floor/grass,
/area/hilbertshotel)
"gm" = (
/obj/structure/lattice,
/turf/open/space/bluespace,
/area/hilbertshotel)
"gK" = (
/obj/structure/flora/ausbushes/sparsegrass,
/obj/structure/flora/ausbushes/brflowers,
/obj/structure/flora/ausbushes/brflowers,
/obj/structure/flora/ausbushes/brflowers,
/turf/open/floor/grass,
/area/hilbertshotel)
"hd" = (
/obj/structure/flora/ausbushes/ppflowers,
/obj/structure/flora/ausbushes/ywflowers,
/turf/open/floor/grass,
/area/hilbertshotel)
"hY" = (
/obj/structure/chair/pew/left{
	dir = 1
	},
/turf/open/floor/grass,
/area/hilbertshotel)
"iy" = (
/obj/structure/flora/ausbushes/ywflowers,
/obj/structure/flora/ausbushes/ywflowers,
/obj/structure/flora/ausbushes/brflowers,
/turf/open/floor/grass,
/area/hilbertshotel)
"ka" = (
/obj/structure/flora/ausbushes/ywflowers,
/obj/structure/flora/ausbushes/ppflowers,
/obj/structure/flora/ausbushes/brflowers,
/turf/open/floor/grass,
/area/hilbertshotel)
"lH" = (
/obj/structure/chair/pew{
	dir = 4
	},
/turf/open/floor/grass,
/area/hilbertshotel)
"mQ" = (
/obj/structure/chair/pew/left,
/turf/open/floor/grass,
/area/hilbertshotel)
"mR" = (
/obj/structure/flora/ausbushes/sparsegrass,
/obj/machinery/light/floor,
/obj/structure/flora/ausbushes/brflowers,
/obj/structure/flora/ausbushes/brflowers,
/turf/open/floor/grass,
/area/hilbertshotel)
"oy" = (
/obj/structure/flora/ausbushes/sparsegrass,
/obj/structure/flora/ausbushes/ppflowers,
/obj/structure/flora/ausbushes/ppflowers,
/turf/open/floor/grass,
/area/hilbertshotel)
"ph" = (
/obj/structure/flora/ausbushes/sparsegrass,
/obj/structure/flora/ausbushes/ppflowers,
/obj/structure/flora/ausbushes/brflowers,
/turf/open/floor/grass,
/area/hilbertshotel)
"rX" = (
/obj/structure/flora/ausbushes/lavendergrass,
/obj/structure/flora/ausbushes/ywflowers,
/obj/structure/flora/ausbushes/brflowers,
/turf/open/floor/grass,
/area/hilbertshotel)
"sg" = (
/obj/structure/flora/ausbushes/sparsegrass,
/obj/machinery/light/floor,
/obj/structure/flora/ausbushes/brflowers,
/turf/open/floor/grass,
/area/hilbertshotel)
"th" = (
/obj/structure/flora/tree/jungle{
	pixel_x = -31;
	pixel_y = 0
	},
/obj/structure/flora/ausbushes/sparsegrass,
/obj/structure/flora/ausbushes/ppflowers,
/turf/open/floor/grass,
/area/hilbertshotel)
"tu" = (
/obj/structure/flora/ausbushes/sparsegrass,
/obj/structure/flora/ausbushes/ywflowers,
/obj/structure/flora/ausbushes/brflowers,
/obj/structure/flora/ausbushes/brflowers,
/turf/open/floor/grass,
/area/hilbertshotel)
"up" = (
/obj/structure/flora/ausbushes/ppflowers,
/obj/structure/flora/ausbushes/ppflowers,
/obj/structure/flora/ausbushes/brflowers,
/obj/structure/flora/ausbushes/brflowers,
/turf/open/floor/grass,
/area/hilbertshotel)
"uD" = (
/obj/structure/flora/ausbushes/ywflowers,
/obj/structure/flora/ausbushes/brflowers,
/turf/open/floor/grass,
/area/hilbertshotel)
"uV" = (
/obj/structure/spacevine,
/obj/structure/flora/ausbushes/brflowers,
/obj/structure/flora/ausbushes/ywflowers,
/turf/closed/indestructible/wood,
/area/hilbertshotel)
"vd" = (
/obj/structure/chair/pew{
	dir = 8
	},
/turf/open/floor/grass,
/area/hilbertshotel)
"vT" = (
/obj/structure/flora/ausbushes/ywflowers,
/obj/structure/flora/ausbushes/ppflowers,
/obj/structure/flora/ausbushes/brflowers,
/obj/structure/flora/ausbushes/brflowers,
/turf/open/floor/grass,
/area/hilbertshotel)
"wc" = (
/obj/structure/flora/ausbushes/brflowers,
/turf/open/floor/grass,
/area/hilbertshotel)
"wF" = (
/obj/structure/flora/ausbushes/ywflowers,
/turf/open/floor/grass,
/area/hilbertshotel)
"zi" = (
/obj/structure/flora/ausbushes/sparsegrass,
/obj/structure/flora/ausbushes/brflowers,
/obj/structure/flora/ausbushes/brflowers,
/turf/open/floor/grass,
/area/hilbertshotel)
"zn" = (
/obj/structure/spacevine,
/obj/structure/flora/ausbushes/ywflowers,
/turf/closed/indestructible/wood,
/area/hilbertshotel)
"zX" = (
/obj/structure/chair/pew/right{
	dir = 1
	},
/turf/open/floor/grass,
/area/hilbertshotel)
"Aq" = (
/obj/structure/flora/ausbushes/lavendergrass,
/obj/structure/flora/ausbushes/brflowers,
/turf/open/floor/grass,
/area/hilbertshotel)
"AB" = (
/obj/structure/flora/ausbushes/sparsegrass,
/obj/structure/flora/ausbushes/ppflowers,
/obj/structure/flora/ausbushes/brflowers,
/obj/structure/flora/ausbushes/brflowers,
/turf/open/floor/grass,
/area/hilbertshotel)
"Cd" = (
/obj/structure/flora/ausbushes/sparsegrass,
/obj/structure/flora/ausbushes/ppflowers,
/obj/structure/flora/ausbushes/ppflowers,
/obj/structure/flora/ausbushes/ywflowers,
/turf/open/floor/grass,
/area/hilbertshotel)
"Cl" = (
/obj/structure/spacevine,
/obj/structure/flora/ausbushes/brflowers,
/obj/structure/flora/ausbushes/ppflowers,
/turf/closed/indestructible/wood,
/area/hilbertshotel)
"Cm" = (
/obj/structure/flora/ausbushes/ppflowers,
/obj/structure/flora/ausbushes/brflowers,
/turf/open/floor/grass,
/area/hilbertshotel)
"CE" = (
/obj/structure/flora/ausbushes/lavendergrass,
/obj/structure/flora/ausbushes/ywflowers,
/turf/open/floor/grass,
/area/hilbertshotel)
"Dd" = (
/obj/structure/spacevine,
/obj/structure/flora/ausbushes/ywflowers,
/obj/structure/flora/ausbushes/ppflowers,
/turf/closed/indestructible/wood,
/area/hilbertshotel)
"Ep" = (
/obj/structure/spacevine,
/obj/structure/flora/ausbushes/brflowers,
/obj/structure/flora/ausbushes/ywflowers,
/obj/structure/flora/ausbushes/ppflowers,
/turf/closed/indestructible/wood,
/area/hilbertshotel)
"FZ" = (
/obj/structure/flora/ausbushes/sparsegrass,
/turf/open/floor/grass,
/area/hilbertshotel)
"Gj" = (
/obj/structure/chair/pew,
/turf/open/floor/grass,
/area/hilbertshotel)
"GQ" = (
/obj/item/candle/infinite,
/turf/open/floor/grass,
/area/hilbertshotel)
"Hx" = (
/obj/structure/flora/ausbushes/sparsegrass,
/obj/structure/flora/ausbushes/brflowers,
/turf/open/floor/grass,
/area/hilbertshotel)
"JW" = (
/obj/structure/chair/pew,
/obj/item/choice_beacon/box/plushie,
/turf/open/floor/grass,
/area/hilbertshotel)
"Kc" = (
/obj/structure/flora/ausbushes/brflowers,
/obj/structure/flora/ausbushes/ppflowers,
/turf/open/floor/grass,
/area/hilbertshotel)
"Kj" = (
/turf/open/floor/grass,
/area/hilbertshotel)
"Mo" = (
/obj/structure/spacevine,
/turf/closed/indestructible/wood,
/area/hilbertshotel)
"MX" = (
/obj/structure/flora/ausbushes/sparsegrass,
/obj/structure/flora/ausbushes/ppflowers,
/obj/structure/flora/ausbushes/ppflowers,
/obj/structure/flora/ausbushes/brflowers,
/turf/open/floor/grass,
/area/hilbertshotel)
"Ox" = (
/obj/structure/flora/ausbushes/lavendergrass,
/obj/structure/flora/ausbushes/ppflowers,
/obj/structure/flora/ausbushes/ywflowers,
/obj/structure/flora/ausbushes/brflowers,
/turf/open/floor/grass,
/area/hilbertshotel)
"OY" = (
/obj/structure/chair/pew/left{
	dir = 4
	},
/turf/open/floor/grass,
/area/hilbertshotel)
"Qf" = (
/obj/structure/chair/pew/right,
/turf/open/floor/grass,
/area/hilbertshotel)
"QL" = (
/obj/structure/chair/pew/right{
	dir = 4
	},
/turf/open/floor/grass,
/area/hilbertshotel)
"RE" = (
/obj/structure/flora/ausbushes/sparsegrass,
/obj/structure/flora/ausbushes/ppflowers,
/obj/structure/flora/ausbushes/ywflowers,
/turf/open/floor/grass,
/area/hilbertshotel)
"RT" = (
/obj/structure/flora/ausbushes/sparsegrass,
/obj/item/lighter/gold,
/obj/structure/flora/ausbushes/brflowers,
/turf/open/floor/grass,
/area/hilbertshotel)
"TH" = (
/obj/structure/flora/ausbushes/sparsegrass,
/obj/structure/flora/ausbushes/ywflowers,
/obj/structure/flora/ausbushes/brflowers,
/turf/open/floor/grass,
/area/hilbertshotel)
"Vh" = (
/obj/structure/flora/ausbushes/lavendergrass,
/obj/structure/flora/ausbushes/brflowers,
/obj/structure/flora/ausbushes/brflowers,
/turf/open/floor/grass,
/area/hilbertshotel)
"Vy" = (
/obj/machinery/light/floor,
/obj/structure/flora/ausbushes/brflowers,
/turf/open/floor/grass,
/area/hilbertshotel)
"We" = (
/obj/structure/chair/pew/left{
	dir = 8
	},
/turf/open/floor/grass,
/area/hilbertshotel)
"Wh" = (
/obj/structure/flora/ausbushes/sparsegrass,
/obj/structure/flora/ausbushes/ywflowers,
/turf/open/floor/grass,
/area/hilbertshotel)
"WO" = (
/obj/structure/chair/pew/right{
	dir = 8
	},
/turf/open/floor/grass,
/area/hilbertshotel)
"Xj" = (
/obj/structure/flora/ausbushes/lavendergrass,
/obj/structure/flora/ausbushes/ppflowers,
/obj/item/storage/fancy/heart_box,
/obj/item/paper/fluff/hilbertshotel/welcomeletter,
/turf/open/floor/grass,
/area/hilbertshotel)
"XX" = (
/turf/closed/indestructible/hoteldoor{
	icon_state = "door_closed";
	icon = 'icons/obj/doors/puzzledoor/default.dmi'
	},
/area/hilbertshotel)
"Zr" = (
/obj/structure/flora/ausbushes/ppflowers,
/obj/structure/flora/ausbushes/brflowers,
/obj/structure/flora/ausbushes/brflowers,
/turf/open/floor/grass,
/area/hilbertshotel)

(1,1,1) = {"
gm
gm
Ep
bg
Ep
XX
Mo
Dd
af
zn
Dd
zn
af
Ep
gm
gm
"}
(2,1,1) = {"
gm
Ep
Cl
Hx
TH
rX
RT
iy
tu
zi
Vh
tu
Hx
zn
Ep
gm
"}
(3,1,1) = {"
Ep
zn
Hx
Wh
hd
Wh
Wh
RE
FZ
up
zi
tu
CE
Hx
Dd
Ep
"}
(4,1,1) = {"
Dd
Zr
uD
Wh
sg
Kj
QL
lH
lH
OY
Kj
aA
Wh
iy
FZ
zn
"}
(5,1,1) = {"
zn
Hx
RE
aA
Kj
Kj
GQ
Kj
Kj
GQ
Kj
Kj
aA
Wh
Hx
zn
"}
(6,1,1) = {"
bg
ph
Cd
Kj
Kj
Kj
Kj
Kj
Kj
Kj
Kj
Kj
Kj
hd
Hx
Ep
"}
(7,1,1) = {"
Cl
ph
oy
mQ
GQ
Kj
Hx
Cm
Hx
Kc
Kj
GQ
hY
Ox
ph
uV
"}
(8,1,1) = {"
zn
MX
vT
Gj
Kj
Kj
Hx
ga
th
zi
Kj
Kj
dn
RE
Hx
Dd
"}
(9,1,1) = {"
uV
ga
Hx
JW
Kj
Kj
Hx
ga
ph
Xj
Kj
Kj
dn
ga
Zr
af
"}
(10,1,1) = {"
zn
ph
Hx
Qf
GQ
Kj
Aq
Hx
uD
Hx
Kj
GQ
zX
ga
Hx
bg
"}
(11,1,1) = {"
zn
up
Hx
Kj
Kj
Kj
Kj
Kj
Kj
Kj
Kj
Kj
Kj
ga
wF
uV
"}
(12,1,1) = {"
Ep
ph
AB
sg
Kj
Kj
GQ
Kj
Kj
GQ
Kj
Kj
aA
AB
Hx
bg
"}
(13,1,1) = {"
Dd
Hx
ka
gK
Vy
Kj
We
vd
vd
WO
Kj
mR
AB
wc
Hx
zn
"}
(14,1,1) = {"
Ep
bg
Hx
Hx
zi
zi
rX
Wh
Wh
TH
Hx
ph
up
zi
bg
Ep
"}
(15,1,1) = {"
gm
Ep
zn
Hx
CE
Wh
tu
Hx
uD
zi
Hx
zi
zi
bg
Ep
fz
"}
(16,1,1) = {"
gm
gm
Ep
bg
Cl
Dd
Cl
Dd
zn
Ep
zn
Dd
Ep
Ep
gm
gm
"}
