//MAP CONVERTED BY dmm2tgm.py THIS HEADER COMMENT PREVENTS RECONVERSION, DO NOT REMOVE
"aa" = (
/turf/open/space/bluespace,
/area/hilbertshotel)
"ab" = (
/obj/machinery/telecomms/relay/preset/auto,
/area/hilbertshotel)
"ag" = (
/obj/effect/turf_decal/siding/wood{
	dir = 8
	},
/turf/open/floor/wood_common/wood_common_dark,
/area/hilbertshotel)
"aj" = (
/turf/closed/wall/mineral/brick,
/area/hilbertshotel)
"am" = (
/obj/machinery/vending/kink{
	shut_up = 1
	},
/turf/open/floor/wood_common/wood_common_dark,
/area/hilbertshotel)
"an" = (
/obj/machinery/door/morgue,
/turf/open/floor/wood_common/wood_common_dark,
/area/hilbertshotel)
"aq" = (
/obj/structure/dresser,
/turf/open/floor/carpet,
/area/hilbertshotel)
"ar" = (
/obj/machinery/light/small{
	dir = 1
	},
/obj/structure/closet/cabinet{
	anchored = 1
	},
/turf/open/floor/carpet,
/area/hilbertshotel)
"at" = (
/turf/closed/indestructible/hoteldoor{
	icon_state = "door_closed";
	icon = 'icons/obj/doors/puzzledoor/default.dmi'
	},
/area/hilbertshotel)
"ax" = (
/turf/open/floor/carpet,
/area/hilbertshotel)
"az" = (
/obj/effect/turf_decal/siding/thinplating/dark/corner{
	dir = 4
	},
/turf/open/floor/mineral/plastitanium,
/area/hilbertshotel)
"aB" = (
/obj/machinery/light/small{
	dir = 8
	},
/turf/open/indestructible/hoteltile,
/area/hilbertshotel)
"aC" = (
/obj/structure/window/reinforced/tinted,
/obj/structure/toilet{
	dir = 8
	},
/turf/open/indestructible/hoteltile,
/area/hilbertshotel)
"aD" = (
/obj/effect/turf_decal/siding/wood,
/obj/structure/closet/crate/bin,
/turf/open/floor/wood_common/wood_common_dark,
/area/hilbertshotel)
"aF" = (
/obj/structure/bed/double,
/turf/open/floor/carpet,
/area/hilbertshotel)
"aI" = (
/obj/structure/mirror{
	pixel_x = -32
	},
/obj/structure/sink{
	dir = 8;
	pixel_x = -12;
	pixel_y = 2
	},
/turf/open/indestructible/hoteltile,
/area/hilbertshotel)
"aJ" = (
/turf/open/indestructible/hoteltile,
/area/hilbertshotel)
"aK" = (
/obj/structure/mineral_door/paperframe,
/turf/open/floor/wood_common/wood_common_dark,
/area/hilbertshotel)
"aL" = (
/obj/effect/turf_decal/siding/wood{
	dir = 1
	},
/obj/structure/window/reinforced/tinted{
	dir = 1
	},
/turf/open/floor/wood_common/wood_common_dark,
/area/hilbertshotel)
"aP" = (
/obj/effect/turf_decal/siding/wood/corner,
/turf/open/floor/wood_common/wood_common_dark,
/area/hilbertshotel)
"aQ" = (
/obj/machinery/light/small,
/obj/structure/table/wood/fancy,
/obj/item/toy/plush/beeplushie,
/turf/open/floor/wood_common/wood_common_dark,
/area/hilbertshotel)
"aT" = (
/turf/open/floor/plasteel/stairs/right,
/area/hilbertshotel)
"aU" = (
/turf/open/floor/plasteel/stairs/left,
/area/hilbertshotel)
"aV" = (
/turf/open/floor/mineral/plastitanium/red,
/area/hilbertshotel)
"aW" = (
/obj/effect/fake_stairs/east,
/turf/open/indestructible/ground/outside/desert,
/area/hilbertshotel)
"aX" = (
/obj/effect/turf_decal/siding/wood/corner{
	dir = 4
	},
/turf/open/floor/wood_common/wood_common_dark,
/area/hilbertshotel)
"aZ" = (
/obj/effect/turf_decal/siding/thinplating/dark,
/turf/open/floor/mineral/plastitanium,
/area/hilbertshotel)
"bl" = (
/obj/structure/table/wood,
/obj/item/storage/fancy/heart_box,
/obj/item/paper/fluff/hilbertshotel/welcomeletter,
/turf/open/floor/carpet,
/area/hilbertshotel)
"bp" = (
/obj/structure/table/reinforced,
/obj/machinery/microwave,
/turf/open/floor/plasteel/cafeteria,
/area/hilbertshotel)
"bq" = (
/obj/machinery/vending/boozeomat{
	shut_up = 1
	},
/turf/open/floor/plasteel/cafeteria,
/area/hilbertshotel)
"bs" = (
/obj/structure/table/reinforced,
/obj/machinery/light{
	dir = 1;
	light_color = "#cee5d2"
	},
/obj/item/reagent_containers/food/drinks/bottle/champagne,
/turf/open/floor/plasteel/cafeteria,
/area/hilbertshotel)
"bw" = (
/obj/structure/table/reinforced,
/obj/structure/sink/kitchen,
/turf/open/floor/plasteel/cafeteria,
/area/hilbertshotel)
"bx" = (
/turf/open/floor/plasteel/cafeteria,
/area/hilbertshotel)
"by" = (
/obj/structure/table/reinforced,
/obj/item/reagent_containers/food/drinks/drinkingglass{
	pixel_x = 5;
	pixel_y = 4
	},
/obj/item/reagent_containers/food/drinks/drinkingglass,
/obj/item/reagent_containers/food/drinks/drinkingglass{
	pixel_x = -5;
	pixel_y = 5
	},
/turf/open/floor/plasteel/cafeteria,
/area/hilbertshotel)
"bz" = (
/obj/structure/closet/secure_closet/freezer/fridge,
/obj/item/reagent_containers/food/condiment/sugar,
/obj/item/reagent_containers/food/condiment/flour,
/obj/item/reagent_containers/food/drinks/beer,
/obj/item/reagent_containers/food/drinks/beer,
/obj/item/reagent_containers/food/drinks/beer,
/obj/item/reagent_containers/food/drinks/beer,
/obj/item/reagent_containers/food/drinks/beer,
/obj/item/reagent_containers/food/drinks/beer,
/obj/item/reagent_containers/food/condiment/rice,
/turf/open/floor/plasteel/cafeteria,
/area/hilbertshotel)
"bA" = (
/obj/machinery/jukebox{
	req_one_access = null;
	area_limited = 1
	},
/obj/effect/turf_decal/siding/wood,
/turf/open/floor/wood_common/wood_common_dark,
/area/hilbertshotel)
"bC" = (
/obj/item/kirbyplants/random,
/obj/effect/turf_decal/siding/wood{
	dir = 6
	},
/turf/open/floor/wood_common/wood_common_dark,
/area/hilbertshotel)
"cA" = (
/obj/effect/turf_decal/siding/wood{
	dir = 4
	},
/obj/structure/window{
	dir = 8
	},
/obj/structure/flora/junglebush,
/obj/structure/flora/junglebush/large,
/turf/open/floor/grass,
/area/hilbertshotel)
"dh" = (
/obj/structure/table/wood,
/obj/structure/showcase/machinery/tv,
/turf/open/floor/carpet,
/area/hilbertshotel)
"dC" = (
/obj/machinery/vending/games{
	shut_up = 1
	},
/obj/effect/turf_decal/siding/wood,
/turf/open/floor/wood_common/wood_common_dark,
/area/hilbertshotel)
"dT" = (
/obj/effect/turf_decal/siding/wood{
	dir = 10
	},
/turf/open/floor/wood_common/wood_common_dark,
/area/hilbertshotel)
"dU" = (
/obj/machinery/light{
	dir = 4
	},
/obj/effect/turf_decal/siding/wood{
	dir = 4
	},
/obj/structure/window{
	dir = 8
	},
/obj/structure/flora/junglebush,
/turf/open/floor/grass,
/area/hilbertshotel)
"gc" = (
/obj/effect/turf_decal/siding/wood{
	dir = 4
	},
/obj/structure/window{
	dir = 8
	},
/obj/structure/window{
	dir = 1
	},
/obj/structure/flora/junglebush,
/obj/structure/flora/junglebush/large,
/turf/open/floor/grass,
/area/hilbertshotel)
"kt" = (
/obj/structure/table/wood,
/obj/item/storage/fancy/candle_box{
	pixel_x = 4
	},
/obj/item/storage/fancy/candle_box{
	pixel_x = -8
	},
/turf/open/floor/carpet,
/area/hilbertshotel)
"kR" = (
/obj/machinery/door/window/survival_pod{
	dir = 4
	},
/turf/open/floor/plasteel/cafeteria,
/area/hilbertshotel)
"kT" = (
/obj/effect/turf_decal/siding/wood{
	dir = 4
	},
/obj/effect/turf_decal/siding/wood{
	dir = 8
	},
/turf/open/floor/wood_common/wood_common_dark,
/area/hilbertshotel)
"lm" = (
/obj/machinery/light/small,
/obj/item/kirbyplants/random,
/obj/effect/turf_decal/siding/wood{
	dir = 10
	},
/turf/open/floor/wood_common/wood_common_dark,
/area/hilbertshotel)
"lo" = (
/obj/machinery/smartfridge/food,
/turf/closed/wall/mineral/brick,
/area/hilbertshotel)
"mf" = (
/obj/effect/turf_decal/siding/thinplating/dark{
	dir = 5
	},
/obj/structure/sign/poster/contraband/random{
	pixel_x = 32
	},
/turf/open/floor/mineral/plastitanium,
/area/hilbertshotel)
"nA" = (
/obj/structure/table/wood,
/turf/open/floor/carpet,
/area/hilbertshotel)
"nE" = (
/obj/effect/turf_decal/siding/wood/corner{
	dir = 4
	},
/obj/effect/turf_decal/siding/wood/corner{
	dir = 1
	},
/obj/effect/turf_decal/siding/wood/corner{
	dir = 8
	},
/turf/open/floor/wood_common/wood_common_dark,
/area/hilbertshotel)
"oY" = (
/obj/effect/turf_decal/siding/thinplating/dark{
	dir = 9
	},
/turf/open/floor/mineral/plastitanium,
/area/hilbertshotel)
"qh" = (
/obj/effect/turf_decal/siding/wood{
	dir = 4
	},
/obj/structure/window{
	dir = 8
	},
/obj/structure/window,
/obj/structure/flora/junglebush,
/turf/open/floor/grass,
/area/hilbertshotel)
"wX" = (
/obj/structure/table/wood,
/obj/item/toy/cards/deck,
/turf/open/floor/carpet,
/area/hilbertshotel)
"xS" = (
/obj/structure/window/reinforced/tinted{
	dir = 1
	},
/obj/machinery/shower{
	dir = 8
	},
/obj/item/soap/deluxe,
/turf/open/indestructible/hoteltile,
/area/hilbertshotel)
"yI" = (
/obj/structure/table/reinforced,
/obj/effect/spawner/lootdrop/three_course_meal,
/turf/open/floor/plasteel/cafeteria,
/area/hilbertshotel)
"GL" = (
/obj/machinery/airalarm/all_access{
	dir = 4;
	pixel_x = -24
	},
/obj/effect/turf_decal/siding/thinplating/dark{
	dir = 8
	},
/turf/open/floor/mineral/plastitanium,
/area/hilbertshotel)
"GN" = (
/obj/structure/chair/stool/bar,
/obj/effect/turf_decal/siding/wood{
	dir = 8
	},
/turf/open/floor/wood_common/wood_common_dark,
/area/hilbertshotel)
"Ka" = (
/obj/effect/turf_decal/siding/wood{
	dir = 1
	},
/turf/open/floor/wood_common/wood_common_dark,
/area/hilbertshotel)
"KK" = (
/obj/machinery/light{
	dir = 8
	},
/obj/machinery/light_switch{
	pixel_x = -32
	},
/turf/open/floor/plasteel/stairs/medium,
/area/hilbertshotel)
"KM" = (
/obj/effect/turf_decal/siding/thinplating/dark{
	dir = 4
	},
/turf/open/floor/mineral/plastitanium,
/area/hilbertshotel)
"Lo" = (
/obj/effect/turf_decal/siding/wood{
	dir = 5
	},
/obj/structure/window/reinforced/tinted{
	dir = 1
	},
/turf/open/floor/wood_common/wood_common_dark,
/area/hilbertshotel)
"LU" = (
/obj/structure/table/reinforced,
/obj/item/candle/infinite,
/obj/effect/turf_decal/siding/wood,
/turf/open/floor/wood_common/wood_common_dark,
/area/hilbertshotel)
"Nv" = (
/obj/machinery/light/small{
	dir = 1
	},
/obj/effect/turf_decal/siding/wood{
	dir = 4
	},
/obj/effect/turf_decal/siding/wood{
	dir = 8
	},
/obj/effect/turf_decal/siding/wood{
	dir = 1
	},
/turf/open/floor/wood_common/wood_common_dark,
/area/hilbertshotel)
"PJ" = (
/obj/effect/turf_decal/siding/thinplating/dark{
	dir = 4
	},
/obj/structure/sign/poster/contraband/random{
	pixel_x = 32
	},
/turf/open/floor/mineral/plastitanium,
/area/hilbertshotel)
"Rh" = (
/obj/structure/table/wood,
/obj/item/pizzabox/margherita{
	pixel_y = 11
	},
/turf/open/floor/carpet,
/area/hilbertshotel)
"TK" = (
/turf/open/floor/plasteel/stairs/medium,
/area/hilbertshotel)
"Vu" = (
/obj/effect/turf_decal/siding/thinplating/dark{
	dir = 8
	},
/turf/open/floor/mineral/plastitanium,
/area/hilbertshotel)
"Xr" = (
/obj/structure/sign/poster/contraband/random,
/turf/closed/wall/mineral/brick,
/area/hilbertshotel)
"XQ" = (
/obj/item/kirbyplants/random,
/obj/effect/turf_decal/siding/wood{
	dir = 5
	},
/turf/open/floor/wood_common/wood_common_dark,
/area/hilbertshotel)
"Yf" = (
/obj/machinery/light_switch{
	pixel_x = -32
	},
/obj/effect/turf_decal/siding/wood{
	dir = 4
	},
/obj/effect/turf_decal/siding/wood{
	dir = 8
	},
/turf/open/floor/wood_common/wood_common_dark,
/area/hilbertshotel)
"Yw" = (
/obj/item/choice_beacon/box/plushie,
/turf/open/floor/carpet,
/area/hilbertshotel)
"YE" = (
/obj/effect/turf_decal/siding/wood/corner{
	dir = 1
	},
/turf/open/floor/wood_common/wood_common_dark,
/area/hilbertshotel)
"YK" = (
/obj/effect/turf_decal/siding/wood/corner{
	dir = 8
	},
/turf/open/floor/wood_common/wood_common_dark,
/area/hilbertshotel)
"Zq" = (
/obj/item/kirbyplants/random,
/obj/effect/turf_decal/siding/thinplating/dark{
	dir = 10
	},
/turf/open/floor/mineral/plastitanium,
/area/hilbertshotel)

(1,1,1) = {"
aa
aa
aa
aa
aa
aa
aa
aa
aa
aa
aa
aa
aa
aa
aa
aa
"}
(2,1,1) = {"
aa
ab
aj
aj
aj
Xr
aj
aj
aj
aj
aj
aj
aj
aj
aj
aa
"}
(3,1,1) = {"
aa
aj
aj
aj
oY
Vu
Vu
KK
GL
Zq
aj
bp
bw
bz
aj
aa
"}
(4,1,1) = {"
aa
aj
aj
at
aV
aV
aV
TK
aV
aZ
aj
yI
bx
bx
lo
aa
"}
(5,1,1) = {"
aa
aj
aj
aj
mf
KM
PJ
TK
az
aZ
aj
bq
bx
bx
aj
aa
"}
(6,1,1) = {"
aa
aj
aj
aj
aj
aj
aj
aj
aW
aW
aj
bs
by
kR
aj
aa
"}
(7,1,1) = {"
aa
aj
aj
aj
aB
aI
aJ
aj
Ka
YK
ag
GN
GN
dT
aj
aa
"}
(8,1,1) = {"
aa
aj
am
aj
aC
aJ
xS
aj
Ka
ax
ax
ax
ax
aD
aj
aa
"}
(9,1,1) = {"
aa
aj
an
aj
aj
aK
aj
Xr
Ka
Yw
wX
bl
ax
LU
aj
aa
"}
(10,1,1) = {"
aa
aj
Nv
Yf
kT
nE
lm
aj
Ka
ax
Rh
dh
ax
bA
aj
aa
"}
(11,1,1) = {"
aa
aj
ax
ax
ax
aL
YK
aU
YE
ax
kt
nA
ax
LU
aj
aa
"}
(12,1,1) = {"
aa
aj
aq
ax
ax
aL
aP
aT
aX
ax
ax
ax
ax
dC
aj
aa
"}
(13,1,1) = {"
aa
aj
ar
ax
aF
Lo
aQ
aj
XQ
gc
dU
cA
qh
bC
aj
aa
"}
(14,1,1) = {"
aa
aj
aj
aj
aj
aj
aj
aj
aj
aj
aj
aj
aj
aj
aj
aa
"}
(15,1,1) = {"
aa
aa
aa
aa
aa
aa
aa
aa
aa
aa
aa
aa
aa
aa
aa
aa
"}
(16,1,1) = {"
aa
aa
aa
aa
aa
aa
aa
aa
aa
aa
aa
aa
aa
aa
aa
aa
"}
