//MAP CONVERTED BY dmm2tgm.py THIS HEADER COMMENT PREVENTS RECONVERSION, DO NOT REMOVE
"aD" = (
/obj/structure/destructible/tribal_torch/wall/lit{
	dir = 2;
	light_color = "#f4e3b0";
	mouse_opacity = 0;
	alpha = 0
	},
/turf/open/floor/plasteel/f13/whitemarble{
	color = "#666666"
	},
/area/hilbertshotel)
"cs" = (
/obj/structure/chair/pew/left,
/obj/structure/destructible/tribal_torch/wall/lit{
	dir = 1;
	pixel_y = 12
	},
/turf/open/indestructible/cobble/dark,
/area/hilbertshotel)
"cJ" = (
/turf/closed/indestructible/f13/matrix,
/area/hilbertshotel)
"de" = (
/obj/effect/turf_decal/siding/wood/corner{
	dir = 1;
	color = "#3B2B1A"
	},
/obj/structure/destructible/tribal_torch/lit,
/obj/effect/decal/cleanable/dirt/dust,
/obj/effect/decal/cleanable/dirt/dust,
/turf/open/indestructible/cobble/dark,
/area/hilbertshotel)
"dl" = (
/obj/structure/chair/pew/right,
/turf/open/indestructible/cobble/dark,
/area/hilbertshotel)
"dN" = (
/obj/structure/table/wood,
/obj/item/binoculars,
/obj/item/binoculars,
/obj/item/binoculars,
/obj/item/binoculars,
/obj/item/binoculars,
/obj/item/binoculars,
/obj/item/binoculars,
/turf/open/indestructible/cobble/dark,
/area/hilbertshotel)
"dZ" = (
/obj/structure/chess/whiteknight,
/obj/effect/decal/cleanable/dirt/dust,
/turf/open/floor/plasteel/f13/whitemarble,
/area/hilbertshotel)
"eh" = (
/obj/effect/turf_decal/siding/wood{
	dir = 8;
	color = "#3B2B1A"
	},
/obj/effect/decal/cleanable/dirt/dust,
/turf/open/indestructible/cobble/dark,
/area/hilbertshotel)
"eP" = (
/obj/effect/turf_decal/siding/wood{
	color = "#3B2B1A"
	},
/obj/effect/decal/cleanable/dirt/dust,
/turf/open/indestructible/cobble/dark,
/area/hilbertshotel)
"fo" = (
/obj/effect/turf_decal/siding/wood/corner{
	dir = 2;
	color = "#3B2B1A"
	},
/obj/structure/destructible/tribal_torch/lit,
/obj/effect/decal/cleanable/dirt/dust,
/turf/open/indestructible/cobble/dark,
/area/hilbertshotel)
"fN" = (
/obj/effect/decal/cleanable/dirt/dust,
/turf/closed/wall/mineral/brick,
/area/hilbertshotel)
"fX" = (
/obj/item/melee/onehanded/slavewhip,
/turf/open/indestructible/cobble/dark,
/area/hilbertshotel)
"gd" = (
/obj/structure/destructible/tribal_torch/wall/lit{
	dir = 4;
	light_color = "#f4e3b0"
	},
/obj/effect/decal/cleanable/dirt/dust,
/obj/structure/chess/blackqueen,
/turf/open/indestructible/cobble/dark,
/area/hilbertshotel)
"hO" = (
/turf/closed/indestructible/hoteldoor{
	icon_state = "door_closed";
	icon = 'icons/obj/doors/puzzledoor/default.dmi'
	},
/area/hilbertshotel)
"hR" = (
/obj/structure/chess/blackpawn,
/turf/open/floor/plasteel/f13/whitemarble,
/area/hilbertshotel)
"is" = (
/turf/closed/wall/mineral/brick,
/area/hilbertshotel)
"iv" = (
/obj/structure/chess/blackrook,
/obj/effect/decal/cleanable/dirt/dust,
/turf/open/floor/plasteel/f13/whitemarble{
	color = "#666666"
	},
/area/hilbertshotel)
"iM" = (
/obj/effect/turf_decal/siding/wood{
	dir = 4;
	color = "#3B2B1A"
	},
/obj/effect/decal/cleanable/dirt/dust,
/turf/open/indestructible/cobble/dark,
/area/hilbertshotel)
"jk" = (
/obj/structure/chair/pew/right{
	dir = 4
	},
/turf/open/indestructible/cobble/dark,
/area/hilbertshotel)
"jB" = (
/obj/structure/table/wood,
/obj/item/toy/clockwork_watch,
/turf/open/indestructible/cobble/dark,
/area/hilbertshotel)
"jD" = (
/obj/item/candle/infinite,
/turf/open/indestructible/cobble/dark,
/area/hilbertshotel)
"kO" = (
/obj/structure/chess/whitequeen,
/turf/open/indestructible/cobble/dark,
/area/hilbertshotel)
"lf" = (
/obj/effect/decal/cleanable/dirt/dust,
/obj/structure/chess/whitequeen,
/turf/open/indestructible/cobble/dark,
/area/hilbertshotel)
"lD" = (
/obj/effect/turf_decal/siding/wood{
	dir = 1;
	color = "#3B2B1A"
	},
/obj/effect/decal/cleanable/dirt/dust,
/obj/effect/decal/cleanable/dirt/dust,
/turf/open/indestructible/cobble/dark,
/area/hilbertshotel)
"lL" = (
/obj/structure/chess/whitepawn,
/turf/open/floor/plasteel/f13/whitemarble{
	color = "#666666"
	},
/area/hilbertshotel)
"lX" = (
/obj/structure/chess/blackknight,
/obj/effect/decal/cleanable/dirt/dust,
/turf/open/floor/plasteel/f13/whitemarble,
/area/hilbertshotel)
"my" = (
/obj/structure/chair/pew/left{
	dir = 4
	},
/obj/effect/decal/cleanable/dirt/dust,
/turf/open/indestructible/cobble/dark,
/area/hilbertshotel)
"ni" = (
/obj/structure/destructible/tribal_torch/wall/lit{
	dir = 2;
	light_color = "#f4e3b0"
	},
/turf/open/indestructible/cobble/dark,
/area/hilbertshotel)
"om" = (
/obj/effect/turf_decal/siding/wood{
	dir = 4;
	color = "#3B2B1A"
	},
/turf/open/indestructible/cobble/dark,
/area/hilbertshotel)
"ou" = (
/obj/effect/turf_decal/siding/wood{
	color = "#3B2B1A"
	},
/obj/structure/destructible/tribal_torch/wall/lit{
	dir = 2;
	light_color = "#f4e3b0";
	mouse_opacity = 0;
	alpha = 0
	},
/obj/effect/decal/cleanable/dirt/dust,
/obj/effect/decal/cleanable/dirt/dust,
/turf/open/indestructible/cobble/dark,
/area/hilbertshotel)
"oF" = (
/obj/effect/decal/cleanable/dirt/dust,
/turf/open/indestructible/cobble/dark,
/area/hilbertshotel)
"oG" = (
/obj/structure/chair/pew/left,
/turf/open/indestructible/cobble/dark,
/area/hilbertshotel)
"ql" = (
/obj/effect/turf_decal/siding/wood{
	color = "#3B2B1A"
	},
/obj/item/candle/infinite,
/obj/effect/decal/cleanable/dirt/dust,
/turf/open/indestructible/cobble/dark,
/area/hilbertshotel)
"qV" = (
/obj/structure/destructible/tribal_torch/lit,
/turf/open/indestructible/cobble/dark,
/area/hilbertshotel)
"rJ" = (
/obj/structure/table/wood,
/obj/effect/decal/cleanable/dirt/dust,
/obj/effect/decal/cleanable/dirt/dust,
/obj/item/binoculars,
/obj/item/binoculars,
/obj/item/binoculars,
/obj/item/binoculars,
/obj/structure/destructible/tribal_torch/wall/lit{
	dir = 1;
	pixel_y = 12
	},
/turf/open/indestructible/cobble/dark,
/area/hilbertshotel)
"rM" = (
/obj/structure/chair/pew,
/obj/effect/decal/cleanable/dirt/dust,
/turf/open/indestructible/cobble/dark,
/area/hilbertshotel)
"sx" = (
/obj/structure/chess/blackpawn,
/obj/structure/destructible/tribal_torch/wall/lit{
	dir = 2;
	light_color = "#f4e3b0";
	mouse_opacity = 0;
	alpha = 0
	},
/turf/open/floor/plasteel/f13/whitemarble,
/area/hilbertshotel)
"sM" = (
/obj/effect/turf_decal/siding/wood/corner{
	dir = 8;
	color = "#3B2B1A"
	},
/obj/structure/destructible/tribal_torch/lit,
/obj/effect/decal/cleanable/dirt/dust,
/turf/open/indestructible/cobble/dark,
/area/hilbertshotel)
"sW" = (
/obj/effect/turf_decal/siding/wood{
	dir = 4;
	color = "#3B2B1A"
	},
/obj/effect/decal/cleanable/dirt/dust,
/obj/effect/decal/cleanable/dirt/dust,
/turf/open/indestructible/cobble/dark,
/area/hilbertshotel)
"th" = (
/obj/structure/destructible/tribal_torch/wall/lit{
	dir = 8;
	light_color = "#f4e3b0"
	},
/turf/open/floor/plasteel/f13/whitemarble,
/area/hilbertshotel)
"tn" = (
/obj/effect/turf_decal/siding/wood{
	dir = 8;
	color = "#3B2B1A"
	},
/obj/item/candle/infinite,
/obj/effect/decal/cleanable/dirt/dust,
/turf/open/indestructible/cobble/dark,
/area/hilbertshotel)
"to" = (
/obj/effect/decal/cleanable/dirt/dust,
/obj/effect/decal/cleanable/dirt/dust,
/turf/open/indestructible/cobble/dark,
/area/hilbertshotel)
"tU" = (
/obj/structure/chair/pew/right,
/obj/effect/decal/cleanable/dirt/dust,
/obj/structure/destructible/tribal_torch/wall/lit{
	dir = 1;
	pixel_y = 12
	},
/turf/open/indestructible/cobble/dark,
/area/hilbertshotel)
"uk" = (
/obj/effect/turf_decal/siding/wood{
	dir = 1;
	color = "#3B2B1A"
	},
/obj/effect/decal/cleanable/dirt/dust,
/obj/item/candle/infinite,
/turf/open/indestructible/cobble/dark,
/area/hilbertshotel)
"uM" = (
/obj/structure/chess/whitepawn,
/turf/open/floor/plasteel/f13/whitemarble,
/area/hilbertshotel)
"uY" = (
/obj/effect/turf_decal/siding/wood{
	dir = 1;
	color = "#3B2B1A"
	},
/turf/open/indestructible/cobble/dark,
/area/hilbertshotel)
"uZ" = (
/obj/structure/chair/pew{
	dir = 8
	},
/turf/open/indestructible/cobble/dark,
/area/hilbertshotel)
"vS" = (
/obj/effect/decal/cleanable/dirt/dust,
/turf/open/floor/plasteel/f13/whitemarble,
/area/hilbertshotel)
"wi" = (
/obj/structure/destructible/tribal_torch/wall/lit{
	dir = 8;
	light_color = "#f4e3b0"
	},
/obj/effect/decal/cleanable/dirt/dust,
/turf/open/floor/plasteel/f13/whitemarble,
/area/hilbertshotel)
"wl" = (
/obj/structure/chess/blackqueen,
/turf/open/indestructible/cobble/dark,
/area/hilbertshotel)
"yb" = (
/turf/open/indestructible/cobble/dark,
/area/hilbertshotel)
"zl" = (
/obj/effect/decal/cleanable/dirt/dust,
/obj/effect/decal/cleanable/dirt/dust,
/turf/open/floor/plasteel/f13/whitemarble,
/area/hilbertshotel)
"zw" = (
/obj/structure/chess/blackpawn,
/obj/structure/destructible/tribal_torch/wall/lit{
	dir = 2;
	light_color = "#f4e3b0";
	mouse_opacity = 0;
	alpha = 0
	},
/turf/open/floor/plasteel/f13/whitemarble{
	color = "#666666"
	},
/area/hilbertshotel)
"zL" = (
/obj/structure/falsewall/wood,
/turf/open/indestructible/cobble/dark,
/area/hilbertshotel)
"An" = (
/obj/structure/chair/pew/left,
/obj/effect/decal/cleanable/dirt/dust,
/turf/open/indestructible/cobble/dark,
/area/hilbertshotel)
"AD" = (
/obj/structure/chess/blackbishop,
/turf/open/floor/plasteel/f13/whitemarble,
/area/hilbertshotel)
"Cp" = (
/obj/structure/chess/whitepawn,
/obj/effect/decal/cleanable/dirt/dust,
/turf/open/floor/plasteel/f13/whitemarble{
	color = "#666666"
	},
/area/hilbertshotel)
"CC" = (
/obj/effect/turf_decal/siding/wood{
	dir = 1;
	color = "#3B2B1A"
	},
/obj/effect/decal/cleanable/dirt/dust,
/turf/open/indestructible/cobble/dark,
/area/hilbertshotel)
"CL" = (
/obj/structure/chess/blackpawn,
/turf/open/floor/plasteel/f13/whitemarble{
	color = "#666666"
	},
/area/hilbertshotel)
"DS" = (
/obj/structure/chair/pew/left,
/obj/effect/decal/cleanable/dirt/dust,
/obj/structure/destructible/tribal_torch/wall/lit{
	dir = 1;
	pixel_y = 12
	},
/turf/open/indestructible/cobble/dark,
/area/hilbertshotel)
"EP" = (
/obj/effect/decal/cleanable/dirt/dust,
/obj/effect/decal/cleanable/dirt/dust,
/obj/effect/decal/cleanable/dirt/dust,
/turf/open/floor/plasteel/f13/whitemarble,
/area/hilbertshotel)
"FZ" = (
/obj/structure/chair/pew{
	dir = 4
	},
/turf/open/indestructible/cobble/dark,
/area/hilbertshotel)
"Gv" = (
/obj/structure/destructible/tribal_torch/wall/lit{
	dir = 4;
	light_color = "#f4e3b0"
	},
/turf/open/floor/plasteel/f13/whitemarble{
	color = "#666666"
	},
/area/hilbertshotel)
"Gx" = (
/obj/structure/chess/whitebishop,
/obj/effect/decal/cleanable/dirt/dust,
/turf/open/floor/plasteel/f13/whitemarble{
	color = "#666666"
	},
/area/hilbertshotel)
"GE" = (
/obj/structure/destructible/tribal_torch/wall/lit{
	dir = 4;
	light_color = "#f4e3b0"
	},
/turf/open/indestructible/cobble/dark,
/area/hilbertshotel)
"Hc" = (
/obj/structure/chess/whitequeen,
/turf/open/floor/plasteel/f13/whitemarble{
	color = "#666666"
	},
/area/hilbertshotel)
"Hj" = (
/obj/structure/destructible/tribal_torch/wall/lit{
	dir = 2;
	light_color = "#f4e3b0"
	},
/turf/open/floor/plasteel/f13/whitemarble,
/area/hilbertshotel)
"JK" = (
/obj/structure/chess/blackking,
/obj/effect/decal/cleanable/dirt/dust,
/turf/open/floor/plasteel/f13/whitemarble,
/area/hilbertshotel)
"JP" = (
/obj/structure/chess/whiterook,
/obj/structure/destructible/tribal_torch/wall/lit{
	dir = 2;
	light_color = "#f4e3b0";
	mouse_opacity = 0;
	alpha = 0
	},
/obj/effect/decal/cleanable/dirt/dust,
/obj/effect/decal/cleanable/dirt/dust,
/turf/open/floor/plasteel/f13/whitemarble{
	color = "#666666"
	},
/area/hilbertshotel)
"JS" = (
/obj/structure/destructible/tribal_torch/wall/lit{
	dir = 2;
	light_color = "#f4e3b0"
	},
/obj/item/candle/infinite,
/turf/open/indestructible/cobble/dark,
/area/hilbertshotel)
"KF" = (
/obj/effect/decal/cleanable/dirt/dust,
/obj/effect/decal/cleanable/dirt/dust,
/obj/item/candle/infinite,
/turf/open/indestructible/cobble/dark,
/area/hilbertshotel)
"Md" = (
/obj/structure/chess/blackbishop,
/turf/open/floor/plasteel/f13/whitemarble{
	color = "#666666"
	},
/area/hilbertshotel)
"MJ" = (
/obj/structure/destructible/tribal_torch/wall/lit{
	dir = 8;
	light_color = "#f4e3b0"
	},
/turf/open/indestructible/cobble/dark,
/area/hilbertshotel)
"OI" = (
/obj/structure/chess/blackqueen,
/turf/open/floor/plasteel/f13/whitemarble{
	color = "#666666"
	},
/area/hilbertshotel)
"Pg" = (
/obj/structure/chess/whitebishop,
/turf/open/floor/plasteel/f13/whitemarble,
/area/hilbertshotel)
"Rx" = (
/obj/item/candle/infinite,
/obj/effect/decal/cleanable/dirt/dust,
/turf/open/indestructible/cobble/dark,
/area/hilbertshotel)
"RD" = (
/obj/structure/chess/blackknight,
/obj/effect/decal/cleanable/dirt/dust,
/turf/open/floor/plasteel/f13/whitemarble{
	color = "#666666"
	},
/area/hilbertshotel)
"RU" = (
/obj/structure/chess/whiteking,
/obj/structure/destructible/tribal_torch/wall/lit{
	dir = 2;
	light_color = "#f4e3b0";
	mouse_opacity = 0;
	alpha = 0
	},
/turf/open/floor/plasteel/f13/whitemarble,
/area/hilbertshotel)
"RV" = (
/obj/structure/destructible/tribal_torch/lit,
/obj/effect/decal/cleanable/dirt/dust,
/turf/open/indestructible/cobble/dark,
/area/hilbertshotel)
"Sd" = (
/obj/effect/decal/cleanable/dirt/dust,
/obj/structure/falsewall/wood,
/turf/open/indestructible/ground/outside/desert,
/area/hilbertshotel)
"So" = (
/obj/structure/chess/whitepawn,
/obj/effect/decal/cleanable/dirt/dust,
/turf/open/floor/plasteel/f13/whitemarble,
/area/hilbertshotel)
"Uc" = (
/obj/structure/chess/whiteknight,
/turf/open/floor/plasteel/f13/whitemarble{
	color = "#666666"
	},
/area/hilbertshotel)
"Uk" = (
/obj/structure/destructible/tribal_torch/wall/lit{
	dir = 2;
	light_color = "#f4e3b0";
	mouse_opacity = 0;
	alpha = 0
	},
/turf/open/floor/plasteel/f13/whitemarble,
/area/hilbertshotel)
"Ur" = (
/obj/effect/turf_decal/siding/wood{
	color = "#3B2B1A"
	},
/turf/open/indestructible/cobble/dark,
/area/hilbertshotel)
"Wu" = (
/obj/effect/decal/cleanable/dirt/dust,
/obj/machinery/vending/kink,
/turf/open/indestructible/cobble/dark,
/area/hilbertshotel)
"Wx" = (
/turf/open/floor/plasteel/f13/whitemarble{
	color = "#666666"
	},
/area/hilbertshotel)
"Wz" = (
/obj/structure/table/wood,
/obj/effect/decal/cleanable/dirt/dust,
/obj/effect/decal/cleanable/dirt/dust,
/obj/item/binoculars,
/obj/item/binoculars,
/obj/item/binoculars,
/obj/item/binoculars,
/turf/open/indestructible/cobble/dark,
/area/hilbertshotel)
"WN" = (
/obj/effect/decal/cleanable/dirt/dust,
/turf/open/floor/plasteel/f13/whitemarble{
	color = "#666666"
	},
/area/hilbertshotel)
"WS" = (
/obj/structure/chair/pew/left{
	dir = 8
	},
/obj/effect/decal/cleanable/dirt/dust,
/turf/open/indestructible/cobble/dark,
/area/hilbertshotel)
"Xf" = (
/turf/open/floor/plasteel/f13/whitemarble,
/area/hilbertshotel)
"Xw" = (
/obj/effect/turf_decal/siding/wood{
	dir = 8;
	color = "#3B2B1A"
	},
/turf/open/indestructible/cobble/dark,
/area/hilbertshotel)
"XE" = (
/obj/structure/chess/blackrook,
/turf/open/floor/plasteel/f13/whitemarble,
/area/hilbertshotel)
"Ya" = (
/obj/structure/chair/pew/right,
/obj/effect/decal/cleanable/dirt/dust,
/turf/open/indestructible/cobble/dark,
/area/hilbertshotel)
"YJ" = (
/obj/structure/chair/pew/right,
/obj/structure/destructible/tribal_torch/wall/lit{
	dir = 1;
	pixel_y = 12
	},
/turf/open/indestructible/cobble/dark,
/area/hilbertshotel)
"YY" = (
/obj/structure/chair/pew/right{
	dir = 8
	},
/obj/effect/decal/cleanable/dirt/dust,
/turf/open/indestructible/cobble/dark,
/area/hilbertshotel)
"Zc" = (
/obj/structure/chair/pew,
/turf/open/indestructible/cobble/dark,
/area/hilbertshotel)
"Ze" = (
/obj/structure/chess/whiterook,
/obj/structure/destructible/tribal_torch/wall/lit{
	dir = 2;
	light_color = "#f4e3b0";
	mouse_opacity = 0;
	alpha = 0
	},
/turf/open/floor/plasteel/f13/whitemarble,
/area/hilbertshotel)
"Zr" = (
/obj/effect/turf_decal/siding/wood/corner{
	dir = 4;
	color = "#3B2B1A"
	},
/obj/structure/destructible/tribal_torch/lit,
/turf/open/indestructible/cobble/dark,
/area/hilbertshotel)

(1,1,1) = {"
is
is
is
is
is
is
is
is
is
is
is
is
is
is
is
is
is
is
is
is
"}
(2,1,1) = {"
is
Wu
zL
oF
MJ
yb
oF
MJ
yb
yb
yb
MJ
yb
yb
th
Xf
Xf
Xf
wi
is
"}
(3,1,1) = {"
is
fN
is
rJ
oF
Wz
RV
oF
jk
FZ
FZ
FZ
my
oF
Xf
Xf
Xf
Xf
Xf
is
"}
(4,1,1) = {"
is
cs
oF
oG
yb
oG
yb
oF
oF
oF
oF
yb
oF
jD
Xf
EP
Xf
vS
Hj
is
"}
(5,1,1) = {"
is
Zc
oF
Zc
oF
Zc
yb
yb
fo
om
om
iM
iM
om
om
iM
sW
Zr
lf
is
"}
(6,1,1) = {"
is
rM
oF
Zc
oF
Zc
yb
yb
ql
XE
zw
vS
WN
Xf
Wx
So
JP
uY
kO
is
"}
(7,1,1) = {"
is
YJ
oF
dl
yb
dl
yb
oF
eP
RD
hR
WN
Xf
aD
Xf
Cp
dZ
uY
yb
is
"}
(8,1,1) = {"
is
dN
yb
RV
yb
RV
yb
to
eP
AD
CL
vS
WN
Xf
Wx
uM
Gx
CC
JS
is
"}
(9,1,1) = {"
hO
yb
yb
oF
yb
oF
yb
KF
Ur
OI
sx
WN
vS
Wx
vS
lL
RU
CC
yb
cJ
"}
(10,1,1) = {"
hO
yb
oF
oF
yb
oF
yb
oF
ou
JK
CL
vS
Wx
Uk
WN
uM
Hc
lD
yb
cJ
"}
(11,1,1) = {"
is
jB
yb
RV
yb
RV
yb
yb
eP
Md
hR
Wx
vS
Wx
vS
lL
Pg
lD
ni
is
"}
(12,1,1) = {"
is
DS
oF
oG
oF
An
yb
yb
eP
lX
zw
zl
Wx
Uk
WN
uM
Uc
uk
yb
is
"}
(13,1,1) = {"
is
rM
oF
Zc
oF
rM
yb
Rx
eP
iv
hR
Wx
Xf
Wx
vS
lL
Ze
lD
yb
is
"}
(14,1,1) = {"
is
rM
oF
rM
oF
Zc
yb
oF
sM
eh
Xw
eh
tn
eh
Xw
Xw
Xw
de
yb
is
"}
(15,1,1) = {"
is
tU
oF
Ya
oF
dl
yb
oF
WN
WN
WN
Wx
WN
oF
yb
yb
jD
oF
ni
is
"}
(16,1,1) = {"
is
is
is
rJ
oF
Wz
qV
oF
Wx
Wx
Wx
Wx
Wx
oF
WS
uZ
uZ
uZ
YY
is
"}
(17,1,1) = {"
is
fX
Sd
oF
GE
yb
wl
gd
WN
Wx
Wx
Gv
Wx
yb
GE
yb
yb
yb
GE
is
"}
(18,1,1) = {"
is
is
is
is
is
is
is
is
is
is
is
is
is
is
is
is
is
is
is
is
"}
