//MAP CONVERTED BY dmm2tgm.py THIS HEADER COMMENT PREVENTS RECONVERSION, DO NOT REMOVE
"bd" = (
/obj/structure/window/reinforced{
	dir = 1
	},
/obj/structure/table/reinforced{
	color = "#c1b6a5"
	},
/obj/machinery/microwave,
/turf/open/floor/plasteel/f13/vault_floor/misc/bar,
/area/hilbertshotel)
"cj" = (
/obj/machinery/vending/snack,
/turf/open/floor/f13{
	dir = 10;
	icon_state = "redmark"
	},
/area/hilbertshotel)
"cy" = (
/obj/structure/chair/booth,
/obj/item/trash/popcorn,
/turf/open/floor/plasteel/f13/vault_floor/misc/vaultrust{
	color = "#d7d7d7"
	},
/area/hilbertshotel)
"cJ" = (
/obj/structure/window/reinforced{
	dir = 1
	},
/obj/structure/table/reinforced{
	color = "#c1b6a5"
	},
/turf/open/floor/plasteel/f13/vault_floor/misc/bar,
/area/hilbertshotel)
"cY" = (
/obj/item/trash/popcorn,
/turf/open/floor/plasteel/f13/vault_floor/misc/vaultrust{
	color = "#a1a1a1"
	},
/area/hilbertshotel)
"dQ" = (
/obj/structure/chair/booth,
/turf/open/floor/plasteel/f13/vault_floor/misc/vaultrust{
	color = "#d7d7d7"
	},
/area/hilbertshotel)
"ew" = (
/turf/open/floor/f13{
	icon_state = "redrustyfull"
	},
/area/hilbertshotel)
"fI" = (
/obj/structure/sink/greyscale{
	dir = 8;
	pixel_x = -12;
	pixel_y = 20
	},
/obj/structure/toilet{
	dir = 4;
	pixel_x = -3
	},
/obj/machinery/light/small{
	dir = 8
	},
/turf/open/floor/plasteel/f13/vault_floor/misc/bar,
/area/hilbertshotel)
"go" = (
/obj/structure/table/reinforced{
	color = "#c1b6a5"
	},
/obj/machinery/computer/terminal{
	dir = 8;
	termtag = "Business"
	},
/turf/open/floor/plasteel/f13/vault_floor/misc/bar,
/area/hilbertshotel)
"gA" = (
/obj/machinery/light{
	dir = 8;
	light_color = "#e8eaff"
	},
/turf/open/floor/plasteel/f13/vault_floor/misc/bar,
/area/hilbertshotel)
"ip" = (
/obj/structure/window/reinforced{
	dir = 1
	},
/obj/structure/table/reinforced{
	color = "#c1b6a5"
	},
/obj/machinery/reagentgrinder,
/turf/open/floor/plasteel/f13/vault_floor/misc/bar,
/area/hilbertshotel)
"jO" = (
/turf/closed/indestructible/hoteldoor{
	icon_state = "door_closed";
	icon = 'icons/obj/doors/puzzledoor/default.dmi'
	},
/area/hilbertshotel)
"kj" = (
/obj/structure/closet/crate/bin{
	pixel_y = 10
	},
/turf/open/floor/plasteel/f13/vault_floor/misc/bar,
/area/hilbertshotel)
"kr" = (
/obj/structure/simple_door/house,
/turf/open/floor/f13{
	icon_state = "redrustyfull"
	},
/area/hilbertshotel)
"kD" = (
/obj/effect/decal/cleanable/dirt,
/turf/open/indestructible/ground/outside/sidewalk,
/area/hilbertshotel)
"lZ" = (
/obj/structure/table/reinforced{
	color = "#c1b6a5"
	},
/turf/closed/wall/f13/ruins{
	color = "#d9cdb9"
	},
/area/hilbertshotel)
"mh" = (
/obj/structure/sign/departments/restroom,
/turf/closed/wall/mineral/concrete{
	desc = "A pre-War wall made of solid concrete.";
	name = "concrete wall"
	},
/area/hilbertshotel)
"mu" = (
/obj/structure/closet/fridge,
/obj/effect/spawner/lootdrop/f13/foodspawner,
/obj/effect/spawner/lootdrop/f13/foodspawner,
/obj/effect/spawner/lootdrop/f13/foodspawner,
/turf/open/floor/plasteel/f13/vault_floor/misc/bar,
/area/hilbertshotel)
"my" = (
/obj/structure/simple_door/house,
/obj/item/lock_bolt{
	dir = 8
	},
/turf/open/floor/plasteel/f13/vault_floor/misc/bar,
/area/hilbertshotel)
"nj" = (
/turf/open/floor/plasteel/f13/vault_floor/misc/vaultrust{
	color = "#a1a1a1"
	},
/area/hilbertshotel)
"oL" = (
/obj/item/trash/can,
/turf/open/floor/plasteel/f13/vault_floor/misc/vaultrust{
	color = "#a1a1a1"
	},
/area/hilbertshotel)
"pl" = (
/obj/structure/table/reinforced{
	color = "#c1b6a5"
	},
/obj/machinery/computer/terminal{
	termtag = "Business"
	},
/turf/open/floor/f13{
	icon_state = "redrustyfull"
	},
/area/hilbertshotel)
"py" = (
/obj/machinery/vending/nukacolavend,
/turf/open/floor/f13{
	dir = 10;
	icon_state = "redmark"
	},
/area/hilbertshotel)
"qx" = (
/turf/open/floor/f13{
	color = "#f7e8e1";
	icon_state = "rampdowntop"
	},
/area/hilbertshotel)
"qO" = (
/turf/closed/wall,
/area/hilbertshotel)
"qV" = (
/obj/structure/chair/booth,
/obj/item/trash/boritos,
/turf/open/floor/plasteel/f13/vault_floor/misc/vaultrust{
	color = "#e4e4e4"
	},
/area/hilbertshotel)
"tL" = (
/obj/structure/table/reinforced{
	color = "#c1b6a5"
	},
/obj/item/reagent_containers/food/snacks/popcorn{
	pixel_y = 10
	},
/obj/item/reagent_containers/food/snacks/popcorn{
	pixel_x = -10;
	pixel_y = 10
	},
/obj/item/reagent_containers/food/snacks/popcorn{
	pixel_x = -10;
	pixel_y = 10
	},
/obj/item/reagent_containers/food/snacks/popcorn{
	pixel_x = 10;
	pixel_y = 10
	},
/obj/item/reagent_containers/food/snacks/popcorn{
	pixel_x = 10
	},
/obj/item/reagent_containers/food/snacks/popcorn{
	pixel_x = -10
	},
/obj/item/reagent_containers/food/snacks/popcorn,
/turf/open/floor/plasteel/f13/vault_floor/misc/bar,
/area/hilbertshotel)
"tX" = (
/turf/open/floor/plasteel/f13/vault_floor/misc/bar,
/area/hilbertshotel)
"vh" = (
/obj/structure/simple_door/house,
/obj/item/lock_bolt{
	dir = 4
	},
/turf/open/floor/plasteel/f13/vault_floor/misc/bar,
/area/hilbertshotel)
"vq" = (
/obj/structure/chair/booth,
/obj/item/trash/candy,
/turf/open/floor/plasteel/f13/vault_floor/misc/vaultrust{
	color = "#b2b2b2"
	},
/area/hilbertshotel)
"wz" = (
/turf/closed/wall/mineral/concrete{
	desc = "A pre-War wall made of solid concrete.";
	name = "concrete wall"
	},
/area/hilbertshotel)
"yo" = (
/turf/closed/wall/mineral/concrete{
	color = "#a9a1a1";
	desc = "A pre-War wall made of solid concrete.";
	name = "concrete wall"
	},
/area/hilbertshotel)
"yV" = (
/turf/open/indestructible/ground/outside/sidewalk{
	icon_state = "horizontalbottomborderbottom0"
	},
/area/hilbertshotel)
"zz" = (
/obj/structure/chair/booth,
/obj/item/trash/raisins,
/obj/machinery/light/small/broken{
	dir = 8
	},
/turf/open/floor/plasteel/f13/vault_floor/misc/vaultrust{
	color = "#e4e4e4"
	},
/area/hilbertshotel)
"zE" = (
/obj/structure/chair/office/dark{
	dir = 4
	},
/turf/open/floor/plasteel/f13/vault_floor/misc/bar,
/area/hilbertshotel)
"Ak" = (
/obj/machinery/light/small/broken{
	dir = 4
	},
/turf/open/floor/plasteel/f13/vault_floor/misc/vaultrust{
	color = "#a1a1a1"
	},
/area/hilbertshotel)
"BD" = (
/obj/structure/simple_door/house,
/turf/open/floor/f13{
	dir = 10;
	icon_state = "redmark"
	},
/area/hilbertshotel)
"BI" = (
/obj/machinery/light{
	dir = 1
	},
/turf/open/floor/f13{
	dir = 10;
	icon_state = "redmark"
	},
/area/hilbertshotel)
"CN" = (
/obj/effect/decal/cleanable/dirt,
/obj/effect/decal/cleanable/dirt,
/turf/open/indestructible/ground/outside/sidewalk,
/area/hilbertshotel)
"CP" = (
/obj/machinery/telecomms/relay/preset/auto,
/turf/open/indestructible/ground/outside/desert,
/area/hilbertshotel)
"CV" = (
/obj/structure/chair/booth,
/obj/item/trash/sosjerky,
/turf/open/floor/plasteel/f13/vault_floor/misc/vaultrust{
	color = "#b2b2b2"
	},
/area/hilbertshotel)
"Em" = (
/obj/machinery/deepfryer,
/obj/machinery/light/broken{
	dir = 4
	},
/turf/open/floor/plasteel/f13/vault_floor/misc/bar,
/area/hilbertshotel)
"Ez" = (
/obj/structure/chair/office/dark{
	dir = 1
	},
/turf/open/floor/plasteel/f13/vault_floor/misc/bar,
/area/hilbertshotel)
"GY" = (
/obj/machinery/light/floor{
	flickering = 1;
	layer = 3;
	pixel_y = -18
	},
/obj/machinery/computer/terminal{
	dir = 1;
	termtag = "Projector";
	pixel_y = -11
	},
/obj/structure/table/reinforced{
	color = "#c1b6a5"
	},
/turf/open/floor/f13{
	icon_state = "redrustyfull"
	},
/area/hilbertshotel)
"GZ" = (
/turf/open/indestructible/ground/outside/sidewalk,
/area/hilbertshotel)
"Hm" = (
/obj/structure/table/reinforced{
	color = "#c1b6a5"
	},
/turf/open/floor/plasteel/f13/vault_floor/misc/bar,
/area/hilbertshotel)
"HF" = (
/obj/item/kirbyplants,
/obj/structure/window/reinforced{
	dir = 1
	},
/turf/open/floor/f13{
	dir = 10;
	icon_state = "redmark"
	},
/area/hilbertshotel)
"LL" = (
/obj/structure/table/reinforced{
	color = "#c1b6a5"
	},
/obj/item/reagent_containers/food/snacks/popcorn{
	pixel_x = -10;
	pixel_y = 20
	},
/obj/item/storage/box/drinkingglasses{
	pixel_x = 5;
	pixel_y = 20
	},
/obj/machinery/computer/terminal{
	dir = 4;
	termtag = "Business"
	},
/turf/open/floor/plasteel/f13/vault_floor/misc/bar,
/area/hilbertshotel)
"LY" = (
/turf/open/floor/f13{
	dir = 10;
	icon_state = "redmark"
	},
/area/hilbertshotel)
"Oc" = (
/obj/structure/filingcabinet/chestdrawer,
/turf/open/floor/plasteel/f13/vault_floor/misc/bar,
/area/hilbertshotel)
"PU" = (
/obj/structure/chair/booth,
/turf/open/floor/plasteel/f13/vault_floor/misc/vaultrust{
	color = "#e4e4e4"
	},
/area/hilbertshotel)
"Qh" = (
/obj/machinery/light/small/broken{
	dir = 8
	},
/turf/open/floor/plasteel/f13/vault_floor/misc/vaultrust{
	color = "#a1a1a1"
	},
/area/hilbertshotel)
"QF" = (
/obj/structure/window/reinforced{
	dir = 1
	},
/obj/structure/table/reinforced{
	color = "#c1b6a5"
	},
/obj/machinery/computer/terminal{
	termtag = "Business"
	},
/turf/open/floor/plasteel/f13/vault_floor/misc/bar,
/area/hilbertshotel)
"St" = (
/obj/structure/chair/booth,
/turf/open/floor/plasteel/f13/vault_floor/misc/vaultrust{
	color = "#b2b2b2"
	},
/area/hilbertshotel)
"SH" = (
/obj/structure/chair/booth,
/obj/item/trash/can,
/turf/open/floor/plasteel/f13/vault_floor/misc/vaultrust{
	color = "#e4e4e4"
	},
/area/hilbertshotel)
"TZ" = (
/obj/structure/chair/booth,
/obj/machinery/light/small/broken{
	dir = 4
	},
/turf/open/floor/plasteel/f13/vault_floor/misc/vaultrust{
	color = "#e4e4e4"
	},
/area/hilbertshotel)
"VB" = (
/obj/machinery/light,
/turf/open/floor/f13{
	dir = 10;
	icon_state = "redmark"
	},
/area/hilbertshotel)
"VI" = (
/obj/structure/table/reinforced{
	color = "#c1b6a5"
	},
/obj/machinery/chem_dispenser/drinks{
	dir = 4
	},
/turf/open/floor/plasteel/f13/vault_floor/misc/bar,
/area/hilbertshotel)
"WK" = (
/turf/open/space/bluespace,
/area/hilbertshotel)
"Xe" = (
/turf/closed/indestructible/f13/matrix,
/area/hilbertshotel)
"XW" = (
/obj/structure/sink/greyscale{
	dir = 4;
	pixel_x = 12;
	pixel_y = 20
	},
/obj/structure/toilet{
	dir = 8
	},
/obj/machinery/light/small/broken{
	dir = 4
	},
/turf/open/floor/plasteel/f13/vault_floor/misc/bar,
/area/hilbertshotel)

(1,1,1) = {"
Xe
Xe
Xe
wz
wz
wz
wz
wz
wz
wz
wz
wz
wz
wz
wz
wz
"}
(2,1,1) = {"
Xe
yV
GZ
QF
Ez
tX
gA
Oc
wz
fI
wz
zz
dQ
St
Qh
wz
"}
(3,1,1) = {"
Xe
yV
GZ
cJ
kj
tX
zE
tX
wz
tX
wz
PU
dQ
St
cY
wz
"}
(4,1,1) = {"
Xe
yV
CN
wz
lZ
lZ
go
tX
mh
my
wz
SH
dQ
St
nj
qO
"}
(5,1,1) = {"
Xe
yV
kD
HF
LY
LY
LY
LY
LY
LY
BD
qx
qx
qx
nj
qO
"}
(6,1,1) = {"
Xe
yV
GZ
wz
BI
LY
py
VB
wz
wz
wz
PU
dQ
CV
nj
qO
"}
(7,1,1) = {"
Xe
yV
GZ
wz
LY
LY
wz
ew
wz
ew
wz
PU
dQ
St
nj
qO
"}
(8,1,1) = {"
jO
yV
CN
kr
LY
LY
pl
ew
kr
ew
GY
PU
dQ
St
nj
qO
"}
(9,1,1) = {"
Xe
yV
kD
wz
LY
LY
wz
ew
wz
ew
wz
PU
cy
St
nj
qO
"}
(10,1,1) = {"
Xe
yV
GZ
wz
BI
LY
cj
VB
wz
wz
wz
PU
dQ
St
nj
qO
"}
(11,1,1) = {"
Xe
yV
GZ
HF
LY
LY
LY
LY
LY
LY
BD
qx
qx
qx
oL
qO
"}
(12,1,1) = {"
Xe
yV
GZ
yo
VI
Hm
LL
tX
mh
vh
wz
qV
dQ
St
nj
qO
"}
(13,1,1) = {"
Xe
yV
CN
ip
tX
tX
tX
tX
wz
tX
wz
PU
dQ
vq
nj
wz
"}
(14,1,1) = {"
Xe
yV
kD
bd
tL
tL
Em
mu
wz
XW
wz
TZ
dQ
St
Ak
wz
"}
(15,1,1) = {"
Xe
Xe
Xe
wz
wz
wz
wz
wz
wz
wz
wz
wz
wz
wz
wz
wz
"}
(16,1,1) = {"
WK
WK
WK
WK
WK
WK
WK
WK
WK
WK
WK
WK
WK
WK
WK
CP
"}
