//MAP CONVERTED BY dmm2tgm.py THIS HEADER COMMENT PREVENTS RECONVERSION, DO NOT REMOVE
"a" = (
/turf/open/indestructible/ground/outside/dirt/desertsand,
/area/hilbertshotel)
"b" = (
/obj/effect/overlay/water/top,
/obj/effect/overlay/water{
	plane = -2
	},
/obj/effect/turf_decal/weather/dirt{
	color = "#FFFF33";
	dir = 1
	},
/obj/effect/turf_decal/weather/dirt{
	color = "#FFFF33";
	dir = 8
	},
/turf/open/floor/plating/beach/water,
/area/hilbertshotel)
"d" = (
/obj/item/fishingrod,
/turf/open/indestructible/ground/outside/dirt/desertsand,
/area/hilbertshotel)
"e" = (
/obj/structure/barricade/tentclothcorner{
	dir = 1;
	color = "#AA4444"
	},
/turf/open/indestructible/ground/outside/dirt/desertsand,
/area/hilbertshotel)
"f" = (
/obj/effect/sound_emitter/birds,
/turf/open/indestructible/ground/outside/dirt/desertsand,
/area/hilbertshotel)
"g" = (
/obj/effect/overlay/palmtree_r,
/turf/open/indestructible/ground/outside/dirt/desertsand,
/area/hilbertshotel)
"h" = (
/obj/effect/overlay/water{
	plane = -2
	},
/obj/effect/overlay/water/top,
/obj/effect/turf_decal/weather/dirt{
	color = "#FFFF33"
	},
/obj/effect/turf_decal/weather/dirt{
	color = "#FFFF33";
	dir = 8
	},
/turf/open/floor/plating/beach/water,
/area/hilbertshotel)
"i" = (
/obj/structure/dresser,
/turf/open/floor/carpet,
/area/hilbertshotel)
"j" = (
/turf/closed/indestructible/f13/matrix,
/area/hilbertshotel)
"k" = (
/obj/effect/overlay/water/top,
/obj/effect/overlay/water{
	plane = -2
	},
/obj/effect/turf_decal/weather/dirtcorner{
	color = "#FFFF33";
	dir = 1
	},
/turf/open/floor/plating/beach/water,
/area/hilbertshotel)
"m" = (
/obj/effect/overlay/palmtree_l,
/turf/open/indestructible/ground/outside/dirt/desertsand,
/area/hilbertshotel)
"n" = (
/turf/open/floor/carpet,
/area/hilbertshotel)
"o" = (
/obj/effect/overlay/water{
	plane = -2
	},
/obj/effect/overlay/water/top,
/obj/effect/turf_decal/weather/dirt{
	color = "#FFFF33"
	},
/obj/effect/turf_decal/weather/dirt{
	color = "#FFFF33";
	dir = 4
	},
/turf/open/floor/plating/beach/water,
/area/hilbertshotel)
"p" = (
/obj/structure/barricade/tentclothedge{
	color = "#AA4444";
	dir = 1;
	pixel_y = 3
	},
/turf/open/indestructible/ground/outside/dirt/desertsand,
/area/hilbertshotel)
"q" = (
/obj/structure/rug/carpet,
/turf/open/floor/carpet,
/area/hilbertshotel)
"r" = (
/obj/effect/overlay/water/top,
/obj/effect/overlay/water{
	plane = -2
	},
/obj/effect/turf_decal/weather/dirt{
	color = "#FFFF33";
	dir = 1
	},
/obj/effect/turf_decal/weather/dirt{
	color = "#FFFF33";
	dir = 4
	},
/turf/open/floor/plating/beach/water,
/area/hilbertshotel)
"s" = (
/turf/open/indestructible/ground/outside/dirt/desertsand{
	color = "#BBBBBB"
	},
/area/hilbertshotel)
"t" = (
/obj/structure/flora/tree/chomp/spalmtree4,
/turf/open/indestructible/ground/outside/dirt/desertsand,
/area/hilbertshotel)
"u" = (
/obj/effect/overlay/water/top,
/obj/effect/overlay/water{
	plane = -2
	},
/obj/effect/turf_decal/weather/dirt{
	color = "#FFFF33";
	dir = 4
	},
/obj/effect/turf_decal/weather/dirt{
	color = "#FFFF33"
	},
/turf/open/floor/plating/beach/water,
/area/hilbertshotel)
"v" = (
/obj/structure/barricade/tentclothcorner{
	dir = 4;
	color = "#AA4444";
	pixel_y = 3
	},
/turf/open/indestructible/ground/outside/dirt/desertsand,
/area/hilbertshotel)
"w" = (
/obj/machinery/vending/kink,
/turf/open/indestructible/ground/outside/dirt/desertsand,
/area/hilbertshotel)
"y" = (
/obj/effect/overlay/water/top,
/obj/effect/overlay/water{
	plane = -2
	},
/obj/effect/turf_decal/weather/dirt{
	color = "#FFFF33";
	dir = 1
	},
/turf/open/floor/plating/beach/water,
/area/hilbertshotel)
"A" = (
/obj/effect/overlay/water/top,
/obj/effect/overlay/water{
	plane = -2
	},
/obj/effect/turf_decal/weather/dirt{
	color = "#FFFF33";
	dir = 4
	},
/turf/open/floor/plating/beach/water,
/area/hilbertshotel)
"B" = (
/obj/effect/overlay/water/top,
/obj/effect/overlay/water{
	plane = -2
	},
/obj/effect/turf_decal/weather/dirt{
	color = "#FFFF33"
	},
/turf/open/floor/plating/beach/water,
/area/hilbertshotel)
"C" = (
/obj/structure/rug/big/rug_red,
/turf/open/floor/carpet,
/area/hilbertshotel)
"D" = (
/obj/structure/barricade/tentclothcorner{
	dir = 2;
	color = "#AA4444";
	pixel_y = 3
	},
/turf/open/indestructible/ground/outside/dirt/desertsand,
/area/hilbertshotel)
"E" = (
/obj/effect/overlay/water/top,
/obj/effect/overlay/water{
	plane = -2
	},
/obj/effect/sound_emitter/creek,
/turf/open/floor/plating/beach/water,
/area/hilbertshotel)
"F" = (
/obj/effect/sound_emitter/foxybar/windycurtains,
/turf/open/indestructible/ground/outside/dirt/desertsand,
/area/hilbertshotel)
"G" = (
/obj/effect/overlay/water/top,
/obj/effect/overlay/water{
	plane = -2
	},
/obj/effect/turf_decal/weather/dirt{
	color = "#FFFF33";
	dir = 8
	},
/turf/open/floor/plating/beach/water,
/area/hilbertshotel)
"H" = (
/obj/structure/flora/tree/chomp/spalmtree,
/turf/open/indestructible/ground/outside/dirt/desertsand,
/area/hilbertshotel)
"I" = (
/obj/effect/overlay/water/top,
/obj/effect/overlay/water{
	plane = -2
	},
/obj/effect/turf_decal/weather/dirtcorner{
	color = "#FFFF33";
	dir = 8
	},
/turf/open/floor/plating/beach/water,
/area/hilbertshotel)
"J" = (
/obj/structure/barricade/tentclothedge{
	color = "#AA4444";
	dir = 8;
	pixel_x = 1
	},
/turf/open/indestructible/ground/outside/dirt/desertsand,
/area/hilbertshotel)
"K" = (
/obj/structure/destructible/tribal_torch/lit{
	pixel_y = 31
	},
/turf/open/indestructible/ground/outside/dirt/desertsand,
/area/hilbertshotel)
"L" = (
/obj/structure/simple_door/tentflap_cloth{
	color = "#AA4444";
	pixel_y = 3
	},
/turf/open/indestructible/ground/outside/dirt/desertsand{
	color = "#BBBBBB"
	},
/area/hilbertshotel)
"M" = (
/obj/effect/overlay/water/top,
/obj/effect/overlay/water{
	plane = -2
	},
/turf/open/floor/plating/beach/water,
/area/hilbertshotel)
"N" = (
/obj/structure/flora/chomp/boulder{
	opacity = 1;
	pixel_y = -23;
	pixel_x = -28
	},
/turf/open/indestructible/ground/outside/dirt/desertsand,
/area/hilbertshotel)
"O" = (
/obj/structure/rug/carpet{
	pixel_y = -11
	},
/turf/open/floor/carpet,
/area/hilbertshotel)
"P" = (
/obj/structure/chair/comfy/throne,
/turf/open/floor/carpet,
/area/hilbertshotel)
"Q" = (
/obj/effect/overlay/water/top,
/obj/effect/overlay/water{
	plane = -2
	},
/obj/effect/turf_decal/weather/dirt{
	color = "#FFFF33";
	dir = 8
	},
/obj/effect/turf_decal/weather/dirt{
	color = "#FFFF33";
	dir = 1
	},
/turf/open/floor/plating/beach/water,
/area/hilbertshotel)
"R" = (
/obj/structure/barricade/tentclothedge{
	color = "#AA4444";
	dir = 1;
	pixel_y = -4
	},
/turf/open/indestructible/ground/outside/dirt/desertsand,
/area/hilbertshotel)
"S" = (
/obj/structure/flora/grass/wasteland{
	icon_state = "tall_grass_6"
	},
/turf/open/indestructible/ground/outside/dirt/desertsand,
/area/hilbertshotel)
"T" = (
/obj/machinery/telecomms/relay/preset/auto,
/turf/open/indestructible/ground/outside/desert,
/area/hilbertshotel)
"U" = (
/obj/structure/chair/stool/bronze,
/turf/open/floor/carpet,
/area/hilbertshotel)
"V" = (
/obj/effect/overlay/water{
	plane = -2
	},
/obj/effect/overlay/water/top,
/obj/effect/turf_decal/weather/dirt{
	color = "#FFFF33"
	},
/turf/open/floor/plating/beach/water,
/area/hilbertshotel)
"W" = (
/turf/closed/indestructible/hoteldoor{
	icon_state = "door_closed";
	icon = 'icons/obj/doors/puzzledoor/default.dmi'
	},
/area/hilbertshotel)
"X" = (
/obj/structure/barricade/tentclothedge{
	color = "#AA4444";
	dir = 4;
	pixel_x = -1
	},
/turf/open/indestructible/ground/outside/dirt/desertsand,
/area/hilbertshotel)
"Y" = (
/obj/structure/flora/tree/chomp/spalmtree,
/obj/effect/overlay/coconut,
/turf/open/indestructible/ground/outside/dirt/desertsand,
/area/hilbertshotel)
"Z" = (
/obj/structure/barricade/tentclothcorner{
	dir = 8;
	color = "#AA4444"
	},
/turf/open/indestructible/ground/outside/dirt/desertsand,
/area/hilbertshotel)

(1,1,1) = {"
T
j
j
j
j
j
j
j
j
j
j
j
j
j
j
j
j
j
j
j
"}
(2,1,1) = {"
j
e
J
J
J
J
v
a
g
F
S
a
a
a
a
a
a
a
a
j
"}
(3,1,1) = {"
j
R
i
U
U
U
p
a
a
a
a
a
a
F
a
a
N
a
a
j
"}
(4,1,1) = {"
j
R
n
C
q
n
p
K
a
a
a
a
a
m
a
a
a
a
a
j
"}
(5,1,1) = {"
j
R
P
O
n
n
L
s
s
s
s
s
s
s
f
a
a
a
a
j
"}
(6,1,1) = {"
j
R
n
n
n
n
p
K
a
f
a
a
a
s
a
Q
G
h
a
j
"}
(7,1,1) = {"
j
R
n
U
U
U
p
S
a
a
b
G
G
G
G
k
M
V
a
j
"}
(8,1,1) = {"
j
Z
X
X
X
X
D
t
a
b
k
M
M
M
M
M
M
V
a
j
"}
(9,1,1) = {"
j
a
a
a
a
a
a
a
a
y
M
M
M
M
M
M
I
o
a
j
"}
(10,1,1) = {"
j
a
a
F
a
S
a
a
d
y
M
M
M
E
M
M
B
S
a
j
"}
(11,1,1) = {"
j
a
a
a
a
a
a
H
a
y
M
M
M
M
M
M
B
F
a
W
"}
(12,1,1) = {"
j
a
N
a
a
a
a
a
a
y
M
M
M
M
M
M
B
a
a
j
"}
(13,1,1) = {"
j
a
a
a
a
a
a
S
a
y
M
M
M
M
M
M
B
a
S
j
"}
(14,1,1) = {"
j
a
a
a
a
a
m
a
a
r
A
A
A
A
A
A
u
a
a
j
"}
(15,1,1) = {"
j
a
a
S
f
a
a
a
a
a
a
a
a
a
a
S
a
a
a
j
"}
(16,1,1) = {"
j
a
a
a
a
a
a
a
N
a
a
a
F
a
a
a
a
g
a
j
"}
(17,1,1) = {"
j
a
a
a
N
a
F
a
a
a
a
a
Y
a
m
a
a
t
a
j
"}
(18,1,1) = {"
j
a
a
a
a
a
a
a
a
a
a
a
a
a
a
a
S
a
a
j
"}
(19,1,1) = {"
j
w
a
a
a
a
a
a
a
a
a
a
a
a
a
a
a
a
a
j
"}
(20,1,1) = {"
j
j
j
j
j
j
j
j
j
j
j
j
j
j
j
j
j
j
j
j
"}
