//MAP CONVERTED BY dmm2tgm.py THIS HEADER COMMENT PREVENTS RECONVERSION, DO NOT REMOVE
"a" = (
/turf/open/floor/grass/snow,
/area/hilbertshotel)
"b" = (
/obj/structure/barricade/tentclothedge{
	pixel_y = 4
	},
/turf/open/floor/plating/ice,
/area/hilbertshotel)
"c" = (
/obj/structure/flora/chomp/bones/lrock4,
/turf/open/floor/grass/snow,
/area/hilbertshotel)
"d" = (
/obj/structure/simple_door/tentflap_cloth{
	pixel_y = 4
	},
/turf/open/floor/plating/ice,
/area/hilbertshotel)
"e" = (
/obj/structure/fireplace,
/turf/open/floor/wood_worn/wood_worn_dark,
/area/hilbertshotel)
"f" = (
/obj/structure/barricade/tentclothcorner{
	pixel_y = 5
	},
/turf/open/floor/grass/snow,
/area/hilbertshotel)
"g" = (
/obj/structure/window/fulltile/civ/nordic_window,
/obj/structure/curtain/directional/north,
/turf/open/floor/wood_worn/wood_worn_dark,
/area/hilbertshotel)
"h" = (
/obj/effect/sound_emitter/crows,
/turf/open/floor/grass/snow,
/area/hilbertshotel)
"i" = (
/obj/structure/barricade/tentclothcorner{
	dir = 1
	},
/turf/open/floor/plating/ice,
/area/hilbertshotel)
"j" = (
/obj/structure/simple_door/tentflap_cloth{
	pixel_y = -4
	},
/turf/open/indestructible/ground/outside/savannah,
/area/hilbertshotel)
"k" = (
/turf/closed/indestructible/f13/matrix,
/area/hilbertshotel)
"l" = (
/obj/structure/barricade/tentclothedge{
	dir = 1;
	pixel_y = -6
	},
/turf/open/floor/grass/snow,
/area/hilbertshotel)
"m" = (
/obj/structure/chair/stool/retro/tan,
/turf/open/floor/plating/ice,
/area/hilbertshotel)
"n" = (
/obj/structure/table/wood/settler,
/turf/open/floor/grass/snow,
/area/hilbertshotel)
"o" = (
/turf/open/floor/plating/beach/water,
/area/hilbertshotel)
"p" = (
/obj/structure/barricade/tentclothedge{
	dir = 4;
	pixel_y = 4;
	pixel_x = -2
	},
/turf/open/floor/grass/snow,
/area/hilbertshotel)
"q" = (
/obj/structure/barricade/tentclothedge{
	pixel_y = 4
	},
/turf/open/floor/grass/snow,
/area/hilbertshotel)
"r" = (
/obj/structure/barricade/tentclothcorner{
	pixel_y = 5
	},
/turf/open/floor/plating/ice,
/area/hilbertshotel)
"s" = (
/turf/closed/wall/f13/wood,
/area/hilbertshotel)
"t" = (
/obj/structure/barricade/tentclothedge{
	pixel_y = 2
	},
/turf/open/floor/grass/snow,
/area/hilbertshotel)
"u" = (
/obj/structure/barricade/tentclothedge{
	dir = 1;
	pixel_y = -4
	},
/turf/open/floor/grass/snow,
/area/hilbertshotel)
"v" = (
/obj/structure/barricade/tentclothcorner{
	dir = 4;
	pixel_y = 4
	},
/turf/open/floor/plating/ice,
/area/hilbertshotel)
"x" = (
/obj/structure/bed/double,
/obj/item/bedsheet/doublesheetbrown,
/turf/open/floor/wood_worn/wood_worn_dark,
/area/hilbertshotel)
"y" = (
/turf/open/floor/plating/ice,
/area/hilbertshotel)
"z" = (
/turf/closed/indestructible/hoteldoor{
	icon_state = "door_closed";
	icon = 'icons/obj/doors/puzzledoor/default.dmi'
	},
/area/hilbertshotel)
"A" = (
/obj/structure/table/wood/settler,
/obj/item/binoculars,
/turf/open/floor/grass/snow,
/area/hilbertshotel)
"B" = (
/obj/structure/barricade/tentclothedge{
	dir = 1;
	pixel_y = -4
	},
/turf/open/floor/plating/ice,
/area/hilbertshotel)
"C" = (
/obj/structure/barricade/tentclothedge{
	dir = 4;
	pixel_y = 4;
	pixel_x = 4
	},
/turf/open/floor/plating/ice,
/area/hilbertshotel)
"D" = (
/obj/structure/table/wood/settler,
/obj/item/gun/ballistic/rifle/hunting,
/obj/item/ammo_box/a3006,
/turf/open/floor/wood_worn/wood_worn_dark,
/area/hilbertshotel)
"E" = (
/turf/open/floor/wood_worn/wood_worn_dark,
/area/hilbertshotel)
"F" = (
/turf/open/indestructible/ground/outside/savannah,
/area/hilbertshotel)
"G" = (
/obj/machinery/microwave/stove,
/turf/open/floor/wood_worn/wood_worn_dark,
/area/hilbertshotel)
"H" = (
/obj/structure/table/wood/settler,
/obj/item/storage/box/matches,
/turf/open/floor/wood_worn/wood_worn_dark,
/area/hilbertshotel)
"I" = (
/obj/effect/sound_emitter/foxybar/windycurtains,
/turf/open/floor/grass/snow,
/area/hilbertshotel)
"J" = (
/obj/structure/barricade/tentclothedge{
	dir = 4;
	pixel_x = -2
	},
/turf/open/floor/plating/ice,
/area/hilbertshotel)
"K" = (
/obj/structure/barricade/tentclothedge{
	dir = 4;
	pixel_x = -2
	},
/turf/open/floor/grass/snow,
/area/hilbertshotel)
"L" = (
/mob/living/simple_animal/radstag,
/turf/open/floor/grass/snow,
/area/hilbertshotel)
"M" = (
/obj/structure/dresser,
/turf/open/floor/wood_worn/wood_worn_dark,
/area/hilbertshotel)
"N" = (
/obj/structure/barricade/tentclothcorner{
	dir = 8
	},
/turf/open/floor/grass/snow,
/area/hilbertshotel)
"O" = (
/obj/structure/simple_door/wood,
/turf/open/floor/wood_worn/wood_worn_dark,
/area/hilbertshotel)
"P" = (
/obj/structure/flora/tallgrass6,
/turf/open/floor/grass/snow,
/area/hilbertshotel)
"Q" = (
/obj/structure/chair/stool/retro/tan,
/obj/item/fishingrod,
/turf/open/floor/plating/ice,
/area/hilbertshotel)
"R" = (
/obj/structure/flora/brushwoodalt,
/turf/open/floor/grass/snow,
/area/hilbertshotel)
"S" = (
/obj/structure/barricade/tentclothcorner{
	dir = 8
	},
/turf/open/floor/plating/ice,
/area/hilbertshotel)
"T" = (
/obj/structure/barricade/tentclothedge{
	pixel_y = 5
	},
/turf/open/floor/grass/snow,
/area/hilbertshotel)
"U" = (
/obj/structure/flora/branch_broken,
/turf/open/floor/grass/snow,
/area/hilbertshotel)
"V" = (
/obj/structure/rug/big/rug_red{
	pixel_x = -16;
	pixel_y = -7
	},
/turf/open/floor/wood_worn/wood_worn_dark,
/area/hilbertshotel)
"W" = (
/obj/structure/flora/tree/pine,
/turf/open/floor/grass/snow,
/area/hilbertshotel)
"X" = (
/obj/structure/chair/stool/retro/tan,
/turf/open/indestructible/ground/outside/savannah,
/area/hilbertshotel)
"Y" = (
/obj/item/stack/sheet/mineral/wood/fifty,
/obj/item/stack/sheet/mineral/wood/fifty,
/obj/item/stack/sheet/mineral/wood/fifty,
/turf/open/floor/wood_worn/wood_worn_dark,
/area/hilbertshotel)
"Z" = (
/obj/structure/table/wood/settler,
/obj/item/melee/onehanded/knife/hunting,
/turf/open/floor/wood_worn/wood_worn_dark,
/area/hilbertshotel)

(1,1,1) = {"
k
k
k
k
k
k
k
k
k
k
k
k
k
k
k
k
k
k
k
k
k
k
k
k
k
k
k
k
k
k
"}
(2,1,1) = {"
k
a
a
a
a
a
a
a
a
a
a
a
P
a
a
a
a
a
a
a
a
a
a
a
a
a
a
a
a
k
"}
(3,1,1) = {"
k
a
a
a
a
a
a
a
a
a
a
a
a
a
a
a
a
a
a
a
L
a
a
a
a
a
c
a
a
k
"}
(4,1,1) = {"
k
a
a
a
a
W
a
a
a
a
a
a
a
a
a
a
a
a
a
a
a
a
a
a
a
a
a
a
a
k
"}
(5,1,1) = {"
k
a
a
a
a
a
U
a
h
a
a
a
a
a
a
U
a
a
a
a
W
a
a
a
a
a
a
a
a
k
"}
(6,1,1) = {"
k
a
P
a
a
c
a
a
a
a
a
W
a
a
a
a
c
a
a
a
a
a
h
a
a
R
a
a
a
k
"}
(7,1,1) = {"
k
a
a
a
a
a
a
a
a
P
a
a
a
a
a
a
a
a
a
a
a
a
a
P
a
a
a
a
a
k
"}
(8,1,1) = {"
k
a
a
a
a
a
a
a
a
a
a
I
R
a
a
a
a
a
P
a
a
a
a
a
a
a
a
a
a
k
"}
(9,1,1) = {"
k
a
W
a
a
a
a
a
a
a
a
a
a
a
a
W
a
a
a
a
a
a
a
a
a
a
W
a
a
k
"}
(10,1,1) = {"
k
a
a
a
P
a
a
a
a
a
a
a
a
a
a
a
a
a
a
I
a
U
a
a
a
a
a
a
a
k
"}
(11,1,1) = {"
k
a
a
a
a
a
a
a
c
a
a
y
y
y
y
y
y
a
a
a
a
a
a
a
a
a
a
a
a
k
"}
(12,1,1) = {"
k
a
R
a
a
h
a
a
a
a
y
y
y
y
y
y
y
a
a
a
a
a
a
a
a
a
a
a
a
k
"}
(13,1,1) = {"
k
a
a
a
a
a
a
a
a
a
y
i
C
C
v
y
y
y
a
a
a
a
a
a
a
a
a
a
a
k
"}
(14,1,1) = {"
k
a
a
a
a
W
a
a
a
a
y
B
m
y
d
y
y
y
a
a
a
a
a
W
a
c
a
a
a
k
"}
(15,1,1) = {"
k
P
a
a
a
a
U
a
I
a
y
B
Q
o
b
y
y
y
a
a
a
a
a
a
a
a
a
a
a
k
"}
(16,1,1) = {"
k
a
a
a
a
a
a
a
a
a
y
S
J
J
r
y
y
y
y
a
a
a
a
a
a
a
a
a
a
k
"}
(17,1,1) = {"
k
a
a
a
a
a
a
a
W
a
y
y
y
y
y
y
y
y
y
a
a
P
a
a
a
a
a
a
a
k
"}
(18,1,1) = {"
k
a
a
a
W
a
a
a
a
a
y
y
y
y
y
y
y
y
a
a
a
a
a
a
a
a
h
a
a
k
"}
(19,1,1) = {"
k
s
s
s
s
s
s
a
a
a
y
y
y
y
y
y
y
a
a
I
a
a
a
a
a
a
a
a
a
k
"}
(20,1,1) = {"
k
s
D
H
G
E
g
a
a
a
W
a
y
y
y
a
a
a
a
a
a
a
a
a
a
a
W
a
a
k
"}
(21,1,1) = {"
k
s
Z
E
E
E
g
a
a
a
a
a
a
F
a
a
a
a
a
a
a
a
a
a
a
a
a
a
a
k
"}
(22,1,1) = {"
k
s
M
Y
E
E
g
a
a
a
a
a
W
F
I
a
P
a
a
l
A
n
T
a
a
a
a
a
a
k
"}
(23,1,1) = {"
k
s
s
e
V
E
O
F
F
F
a
a
a
F
a
a
a
a
a
u
X
X
t
a
a
U
a
a
a
k
"}
(24,1,1) = {"
k
s
x
E
E
E
s
a
a
F
F
F
F
F
F
F
F
F
F
j
F
F
q
a
a
a
a
a
a
k
"}
(25,1,1) = {"
k
s
s
s
s
s
s
a
a
a
a
W
a
a
W
a
a
a
a
N
K
p
f
a
a
a
a
a
a
k
"}
(26,1,1) = {"
k
a
a
a
P
a
a
I
a
a
a
a
a
a
a
a
a
a
a
a
a
a
a
a
a
a
a
P
a
k
"}
(27,1,1) = {"
k
a
a
a
a
a
a
a
a
R
a
a
a
a
a
c
a
a
a
a
a
W
a
a
a
a
a
a
a
k
"}
(28,1,1) = {"
k
a
W
a
a
a
a
a
a
a
a
P
a
a
a
a
a
a
a
a
a
a
a
a
a
a
a
a
a
k
"}
(29,1,1) = {"
k
a
a
a
a
a
a
a
a
a
W
a
a
a
a
a
a
a
a
a
a
a
a
a
a
a
a
a
a
k
"}
(30,1,1) = {"
k
k
k
k
k
k
k
z
k
k
k
k
k
k
k
k
k
k
k
k
k
k
k
k
k
k
k
k
k
k
"}
