//MAP CONVERTED BY dmm2tgm.py THIS HEADER COMMENT PREVENTS RECONVERSION, DO NOT REMOVE
"a" = (
/turf/open/water,
/area/f13/wasteland)
"c" = (
/obj/structure/lattice/catwalk,
/obj/structure/railing{
	color = "#A47449";
	layer = 4;
	pixel_y = -2
	},
/turf/open/water,
/area/f13/wasteland)
"d" = (
/obj/structure/railing{
	color = "#A47449";
	dir = 8;
	pixel_x = -3
	},
/turf/open/water,
/area/f13/wasteland)
"j" = (
/obj/structure/railing{
	color = "#A47449";
	dir = 8;
	pixel_x = -3
	},
/obj/structure/railing{
	color = "#A47449";
	layer = 4;
	pixel_y = -2
	},
/turf/open/water,
/area/f13/wasteland)
"B" = (
/turf/closed/indestructible/f13vaultrusted,
/area/f13/wasteland)
"D" = (
/obj/structure/lattice/catwalk,
/turf/open/water,
/area/f13/wasteland)
"K" = (
/obj/structure/railing{
	color = "#A47449";
	layer = 4;
	pixel_y = -2
	},
/turf/open/water,
/area/f13/wasteland)

(1,1,1) = {"
B
B
B
B
B
B
B
B
B
B
B
B
B
B
B
B
B
B
B
B
"}
(2,1,1) = {"
B
D
D
D
D
D
D
D
D
D
D
D
D
D
D
D
D
D
D
B
"}
(3,1,1) = {"
B
D
c
d
d
d
d
d
d
d
d
d
d
d
d
d
j
D
D
B
"}
(4,1,1) = {"
B
D
c
a
a
a
a
a
a
a
a
a
a
a
a
a
K
D
D
B
"}
(5,1,1) = {"
B
B
B
B
B
B
a
a
B
B
a
a
B
B
B
B
B
B
B
B
"}
(6,1,1) = {"
B
a
a
a
a
B
a
a
B
B
a
a
B
a
a
a
a
a
a
B
"}
(7,1,1) = {"
B
a
a
a
a
B
a
a
B
B
a
a
B
a
a
a
a
a
a
B
"}
(8,1,1) = {"
B
a
a
B
B
B
a
a
B
B
a
a
B
a
a
a
B
a
a
B
"}
(9,1,1) = {"
B
a
a
a
a
B
a
a
B
B
a
a
B
a
a
a
B
a
a
B
"}
(10,1,1) = {"
B
a
a
a
a
B
a
a
B
B
a
a
B
a
a
a
B
a
a
B
"}
(11,1,1) = {"
B
a
a
B
B
B
a
a
B
B
a
a
B
a
a
a
B
a
a
B
"}
(12,1,1) = {"
B
a
a
a
a
B
a
a
B
B
a
a
B
a
a
a
B
a
a
B
"}
(13,1,1) = {"
B
a
a
a
a
B
a
a
B
B
a
a
B
a
a
a
B
a
a
B
"}
(14,1,1) = {"
B
a
a
B
B
B
a
a
B
B
a
a
B
a
a
a
B
a
a
B
"}
(15,1,1) = {"
B
a
a
a
a
B
a
a
B
B
a
a
B
a
a
a
B
a
a
B
"}
(16,1,1) = {"
B
a
a
a
a
B
a
a
B
B
a
a
B
a
a
a
B
a
a
B
"}
(17,1,1) = {"
B
a
a
B
B
B
B
B
B
B
a
a
B
B
B
B
B
a
a
B
"}
(18,1,1) = {"
B
a
a
a
a
a
a
a
a
a
a
a
a
a
a
a
a
a
a
B
"}
(19,1,1) = {"
B
a
a
a
a
a
a
a
a
a
a
a
a
a
a
a
a
a
a
B
"}
(20,1,1) = {"
B
B
B
B
B
B
B
B
B
B
B
B
B
B
B
B
B
B
B
B
"}
