//MAP CONVERTED BY dmm2tgm.py THIS HEADER COMMENT PREVENTS RECONVERSION, DO NOT REMOVE
"a" = (
/turf/open/space/bluespace,
/area/hilbertshotel)
"b" = (
/turf/closed/wall/mineral/brick,
/area/hilbertshotel)
"c" = (
/turf/open/floor/wood_common/wood_common_dark,
/area/hilbertshotel)
"d" = (
/turf/open/indestructible/hoteltile,
/area/hilbertshotel)
"e" = (
/turf/closed/indestructible/hoteldoor,
/area/hilbertshotel)
"X" = (
/turf/open/space/bluespace,
/area/space)

(1,1,1) = {"
X
a
a
a
a
a
a
a
a
a
a
a
a
a
a
a
"}
(2,1,1) = {"
X
a
b
b
b
b
b
e
b
b
b
b
b
b
b
a
"}
(3,1,1) = {"
X
a
b
c
c
c
c
c
c
c
c
c
c
c
b
a
"}
(4,1,1) = {"
X
a
b
c
c
c
c
c
c
c
c
c
c
c
b
a
"}
(5,1,1) = {"
X
a
b
c
c
c
c
c
c
c
c
c
c
c
b
a
"}
(6,1,1) = {"
X
a
b
c
c
c
c
c
c
c
c
c
c
c
b
a
"}
(7,1,1) = {"
X
a
b
c
c
c
c
c
c
c
c
c
c
c
b
a
"}
(8,1,1) = {"
X
a
b
b
b
c
b
b
b
b
b
b
b
b
b
a
"}
(9,1,1) = {"
X
a
b
c
c
c
c
c
c
d
d
d
d
d
b
a
"}
(10,1,1) = {"
X
a
b
c
c
c
c
c
b
d
d
d
d
d
b
a
"}
(11,1,1) = {"
X
a
b
c
c
c
c
c
b
d
d
d
d
d
b
a
"}
(12,1,1) = {"
X
a
b
c
c
c
c
c
b
d
d
d
d
d
b
a
"}
(13,1,1) = {"
X
a
b
c
c
c
c
c
b
d
d
d
d
d
b
a
"}
(14,1,1) = {"
X
a
b
c
c
c
c
c
b
d
d
d
d
d
b
a
"}
(15,1,1) = {"
X
a
b
b
b
b
b
b
b
b
b
b
b
b
b
a
"}
(16,1,1) = {"
X
a
a
a
a
a
a
a
a
a
a
a
a
a
a
a
"}
