//MAP CONVERTED BY dmm2tgm.py THIS HEADER COMMENT PREVENTS RECONVERSION, DO NOT REMOVE
"aa" = (
/obj/structure/window/reinforced/tinted{
	dir = 8
	},
/obj/structure/window/reinforced/tinted,
/turf/open/indestructible/hoteltile,
/area/hilbertshotel)
"bx" = (
/obj/structure/mineral_door/wood,
/turf/open/floor/wood_common/wood_common_dark,
/area/hilbertshotel)
"dl" = (
/obj/structure/table/reinforced,
/obj/item/reagent_containers/food/drinks/bottle/champagne,
/turf/open/floor/plasteel/cafeteria,
/area/hilbertshotel)
"dH" = (
/obj/structure/toilet{
	dir = 8
	},
/obj/structure/window/reinforced/tinted{
	dir = 1
	},
/obj/structure/window/reinforced/tinted{
	dir = 8
	},
/turf/open/indestructible/hoteltile,
/area/hilbertshotel)
"dN" = (
/obj/structure/table/reinforced,
/obj/item/soap/deluxe,
/obj/machinery/light/small{
	dir = 8
	},
/turf/open/indestructible/hoteltile,
/area/hilbertshotel)
"hn" = (
/obj/item/toy/plush/beeplushie,
/obj/structure/table/wood/fancy,
/turf/open/floor/wood_common/wood_common_dark,
/area/hilbertshotel)
"hz" = (
/obj/structure/mineral_door/paperframe,
/turf/open/floor/wood_common/wood_common_dark,
/area/hilbertshotel)
"hK" = (
/obj/structure/chair/stool/bar,
/turf/open/floor/wood_common/wood_common_dark,
/area/hilbertshotel)
"iq" = (
/obj/structure/table/reinforced,
/obj/effect/spawner/lootdrop/three_course_meal,
/turf/open/floor/plasteel/cafeteria,
/area/hilbertshotel)
"jS" = (
/obj/structure/mirror{
	pixel_x = -32
	},
/obj/structure/sink{
	dir = 8;
	pixel_x = -12;
	pixel_y = 2
	},
/turf/open/indestructible/hoteltile,
/area/hilbertshotel)
"kU" = (
/obj/machinery/telecomms/relay/preset/auto,
/turf/open/indestructible/ground/outside/desert,
/area/hilbertshotel)
"kX" = (
/obj/structure/table/reinforced,
/turf/open/floor/plasteel/cafeteria,
/area/hilbertshotel)
"qH" = (
/turf/open/floor/plasteel/stairs/left,
/area/hilbertshotel)
"re" = (
/obj/structure/table/reinforced,
/obj/item/reagent_containers/food/drinks/drinkingglass,
/obj/item/reagent_containers/food/drinks/drinkingglass{
	pixel_x = -2;
	pixel_y = 4
	},
/obj/item/reagent_containers/food/drinks/drinkingglass{
	pixel_y = 7
	},
/obj/item/reagent_containers/food/drinks/drinkingglass{
	pixel_x = 5;
	pixel_y = 4
	},
/obj/item/reagent_containers/food/drinks/drinkingglass{
	pixel_x = -5;
	pixel_y = 5
	},
/turf/open/floor/plasteel/cafeteria,
/area/hilbertshotel)
"su" = (
/obj/structure/dresser,
/obj/machinery/light/small{
	dir = 4
	},
/turf/open/floor/wood_common/wood_common_dark,
/area/hilbertshotel)
"uU" = (
/obj/machinery/shower{
	dir = 8
	},
/turf/open/indestructible/hoteltile,
/area/hilbertshotel)
"wf" = (
/turf/open/indestructible/hoteltile,
/area/hilbertshotel)
"wC" = (
/obj/structure/lattice,
/turf/closed/wall/mineral/brick,
/area/hilbertshotel)
"wT" = (
/obj/machinery/light/small{
	dir = 1
	},
/turf/open/indestructible/hoteltile,
/area/hilbertshotel)
"xG" = (
/obj/structure/table/reinforced,
/obj/machinery/light/small{
	dir = 4
	},
/turf/open/floor/plasteel/cafeteria,
/area/hilbertshotel)
"yh" = (
/obj/machinery/light/small{
	dir = 8
	},
/turf/open/floor/wood_common/wood_common_dark,
/area/hilbertshotel)
"zo" = (
/obj/machinery/airalarm/all_access{
	dir = 4;
	pixel_x = -24
	},
/turf/open/floor/plasteel/cafeteria,
/area/hilbertshotel)
"zD" = (
/obj/machinery/jukebox{
	req_one_access = null
	},
/turf/open/floor/wood_common/wood_common_dark,
/area/hilbertshotel)
"AZ" = (
/obj/structure/chair/comfy/brown{
	dir = 1
	},
/turf/open/floor/wood_common/wood_common_dark,
/area/hilbertshotel)
"Bt" = (
/obj/structure/window/reinforced/tinted{
	dir = 8
	},
/obj/structure/window/reinforced/tinted{
	dir = 1
	},
/turf/open/indestructible/hoteltile,
/area/hilbertshotel)
"BG" = (
/obj/structure/sign/painting/library{
	pixel_y = 32
	},
/turf/open/floor/wood_common/wood_common_dark,
/area/hilbertshotel)
"Ce" = (
/turf/open/floor/plasteel/stairs/medium,
/area/hilbertshotel)
"CN" = (
/turf/open/floor/plasteel/cafeteria,
/area/hilbertshotel)
"FR" = (
/obj/item/bikehorn/rubberducky,
/obj/machinery/light/small{
	dir = 4
	},
/turf/open/indestructible/hoteltile,
/area/hilbertshotel)
"GW" = (
/turf/open/space/bluespace,
/area/hilbertshotel)
"Ii" = (
/obj/machinery/vending/kink,
/turf/open/floor/wood_common/wood_common_dark,
/area/hilbertshotel)
"Ir" = (
/obj/structure/table/reinforced,
/turf/open/floor/wood_common/wood_common_dark,
/area/hilbertshotel)
"IT" = (
/turf/closed/indestructible/hoteldoor,
/area/hilbertshotel)
"Js" = (
/obj/machinery/smartfridge/food,
/turf/open/floor/plasteel/cafeteria,
/area/hilbertshotel)
"JK" = (
/obj/structure/fireplace{
	pixel_y = -6
	},
/turf/open/floor/wood_common/wood_common_dark,
/area/hilbertshotel)
"KD" = (
/obj/machinery/light/small,
/turf/open/floor/wood_common/wood_common_dark,
/area/hilbertshotel)
"Ld" = (
/obj/machinery/light/small{
	dir = 1
	},
/turf/open/floor/wood_common/wood_common_dark,
/area/hilbertshotel)
"LT" = (
/obj/structure/closet/crate/bin,
/obj/machinery/light/small{
	dir = 4
	},
/turf/open/floor/wood_common/wood_common_dark,
/area/hilbertshotel)
"LX" = (
/obj/structure/window/reinforced/tinted{
	dir = 8
	},
/turf/open/indestructible/hoteltile,
/area/hilbertshotel)
"MA" = (
/obj/structure/table/wood/fancy,
/obj/item/storage/fancy/heart_box,
/obj/item/paper/fluff/hilbertshotel/welcomeletter,
/turf/open/floor/wood_common/wood_common_dark,
/area/hilbertshotel)
"MZ" = (
/turf/open/floor/wood_common/wood_common_dark,
/area/hilbertshotel)
"NV" = (
/obj/structure/table/reinforced,
/obj/machinery/microwave,
/turf/open/floor/plasteel/cafeteria,
/area/hilbertshotel)
"Ow" = (
/obj/machinery/light/small{
	dir = 8
	},
/turf/open/floor/plasteel/cafeteria,
/area/hilbertshotel)
"QV" = (
/obj/structure/bed/double,
/turf/open/floor/wood_common/wood_common_dark,
/area/hilbertshotel)
"Rt" = (
/obj/machinery/light/small{
	dir = 4
	},
/turf/open/floor/wood_common/wood_common_dark,
/area/hilbertshotel)
"Si" = (
/turf/closed/wall/mineral/brick,
/area/hilbertshotel)
"Tt" = (
/turf/open/floor/plasteel/stairs/right,
/area/hilbertshotel)
"Uc" = (
/obj/item/kirbyplants/random,
/turf/open/floor/wood_common/wood_common_dark,
/area/hilbertshotel)
"Um" = (
/obj/item/candle/infinite,
/obj/structure/table/wood/fancy,
/turf/open/floor/wood_common/wood_common_dark,
/area/hilbertshotel)
"Us" = (
/obj/structure/closet/cabinet{
	anchored = 1
	},
/turf/open/floor/wood_common/wood_common_dark,
/area/hilbertshotel)
"VT" = (
/obj/structure/table/reinforced,
/obj/structure/sink/kitchen,
/obj/machinery/light/small,
/turf/open/floor/plasteel/cafeteria,
/area/hilbertshotel)
"WK" = (
/obj/structure/table/reinforced,
/obj/item/soap/deluxe,
/turf/open/indestructible/hoteltile,
/area/hilbertshotel)
"WM" = (
/obj/structure/curtain,
/turf/open/indestructible/hoteltile,
/area/hilbertshotel)
"YD" = (
/obj/machinery/light/small,
/turf/open/indestructible/hoteltile,
/area/hilbertshotel)
"YR" = (
/obj/structure/table/wood/fancy,
/obj/item/stack/spacecash/c100,
/turf/open/floor/wood_common/wood_common_dark,
/area/hilbertshotel)
"Zx" = (
/turf/open/floor/carpet,
/area/hilbertshotel)

(1,1,1) = {"
GW
GW
GW
GW
GW
GW
GW
GW
GW
GW
GW
GW
GW
GW
GW
GW
"}
(2,1,1) = {"
GW
GW
Si
Si
Si
Si
Si
IT
Si
Si
Si
Si
Si
Si
Si
GW
"}
(3,1,1) = {"
GW
GW
Si
Uc
yh
MZ
MZ
MZ
yh
MZ
zo
Ow
NV
kX
Si
GW
"}
(4,1,1) = {"
GW
GW
Si
Ir
qH
MZ
YR
AZ
MZ
hK
kX
CN
CN
kX
Si
GW
"}
(5,1,1) = {"
GW
GW
Si
Ir
Ce
MZ
Um
AZ
MZ
hK
iq
CN
CN
VT
Si
GW
"}
(6,1,1) = {"
GW
GW
Si
Ir
Tt
MZ
MA
AZ
MZ
hK
re
CN
CN
kX
Si
GW
"}
(7,1,1) = {"
GW
kU
Si
zD
Rt
MZ
MZ
MZ
LT
Uc
dl
xG
Js
kX
Si
GW
"}
(8,1,1) = {"
GW
GW
Si
Si
Si
bx
Si
Si
Si
Si
Si
Si
Si
Si
Si
GW
"}
(9,1,1) = {"
GW
GW
wC
Uc
yh
MZ
MZ
MZ
hz
wf
jS
dN
jS
WK
Si
GW
"}
(10,1,1) = {"
GW
GW
wC
BG
Zx
Zx
Zx
MZ
Si
wf
wf
wf
wf
wf
Si
GW
"}
(11,1,1) = {"
GW
GW
wC
JK
Zx
Zx
Zx
KD
Si
wT
wf
dH
wf
YD
Si
GW
"}
(12,1,1) = {"
GW
GW
wC
BG
Zx
Zx
Zx
MZ
Si
WM
Bt
LX
aa
WM
Si
GW
"}
(13,1,1) = {"
GW
GW
Si
Ld
MZ
MZ
MZ
MZ
Si
wf
wf
wf
wf
wf
Si
GW
"}
(14,1,1) = {"
GW
GW
Si
Ii
Us
QV
su
hn
Si
wf
uU
FR
uU
wf
Si
GW
"}
(15,1,1) = {"
GW
GW
Si
Si
Si
Si
Si
Si
Si
Si
Si
Si
Si
Si
Si
GW
"}
(16,1,1) = {"
GW
GW
GW
GW
GW
GW
GW
GW
GW
GW
GW
GW
GW
GW
GW
GW
"}
