"aa" = (/turf/indestructible/matrix,/area/djstation)
"ab" = (/turf/simulated/floor/engine/wasteland,/area/djstation)
"ac" = (/turf/simulated/floor/engine/housebase{dir = 4; icon_state = "outerpavement"},/area/djstation)
"ad" = (/obj/structure/ruins{icon_state = "wasteland2"},/turf/simulated/floor/engine/wasteland,/area/djstation)
"ae" = (/turf/simulated/floor/engine/housebase{icon_state = "housewasteland"},/area/djstation)
"af" = (/turf/indestructible/repconn{icon_state = "wasteland3"},/area/djstation)
"ag" = (/turf/simulated/floor/engine/housebase{dir = 8; icon_state = "outerpavement"},/area/djstation)
"ah" = (/turf/simulated/floor/engine/housebase{dir = 2; icon_state = "outerpavementcorner"},/area/djstation)
"ai" = (/turf/simulated/floor/engine/housebase{icon_state = "outerpavement"},/area/djstation)
"aj" = (/turf/simulated/floor/engine/housebase{dir = 6; icon_state = "outerpavement"},/area/djstation)
"ak" = (/obj/structure/ruins{icon_state = "wasteland3bottom"},/turf/simulated/floor/engine/wasteland,/area/djstation)
"al" = (/turf/simulated/floor/engine/housebase{icon_state = "housewood3-broken1"},/area/djstation)
"am" = (/turf/simulated/floor/engine/housebase,/area/djstation)
"an" = (/turf/simulated/floor/engine/housebase{icon_state = "housewood3-broken2"},/area/djstation)
"ao" = (/obj/item/weapon/bikehorn,/turf/simulated/floor/engine/house{icon_state = "housewood1-broken"},/area/djstation)
"ap" = (/turf/simulated/floor/engine/housebase{dir = 10; icon_state = "outerpavement"},/area/djstation)
"aq" = (/turf/simulated/floor/engine/housebase{dir = 8; icon_state = "outerpavementcorner"},/area/djstation)
"ar" = (/obj/structure/flora/grass/wasteland,/turf/simulated/floor/engine/wasteland,/area/djstation)
"as" = (/turf/indestructible/repconn{icon_state = "supermart6"},/area/djstation)
"at" = (/turf/indestructible/repconn{icon_state = "storeprewindowleft"},/area/djstation)
"au" = (/turf/indestructible/robco{icon_state = "storewindowleft"},/area/djstation)
"av" = (/turf/indestructible/robco{icon_state = "storewindowhorizontal"},/area/djstation)
"aw" = (/turf/indestructible/robco{icon_state = "storewindowright"},/area/djstation)
"ax" = (/turf/indestructible/repconn{icon_state = "storeprewindowright"},/area/djstation)
"ay" = (/turf/indestructible/repconn{icon_state = "supermart14"},/area/djstation)
"az" = (/turf/indestructible/repconn{icon_state = "supermart12"},/area/djstation)
"aA" = (/turf/indestructible/repconn{icon_state = "supermart10"},/area/djstation)
"aB" = (/turf/indestructible/repconn{icon_state = "wasteland10"},/area/djstation)
"aC" = (/turf/indestructible/repconn{icon_state = "wasteland12"},/area/djstation)
"aD" = (/obj/effect/decal/decoration,/turf/indestructible/corvega{icon_state = "dirtyglass"; name = "locked room"},/area/djstation)
"aE" = (/turf/indestructible/repconn{icon_state = "supermart3"},/area/djstation)
"aF" = (/obj/structure/closet,/obj/machinery/light{dir = 1},/turf/simulated/floor/engine/vaulttec{icon_state = "floordirty"},/area/djstation)
"aG" = (/turf/simulated/floor/engine/vaulttec{icon_state = "floorrusty"},/area/djstation)
"aH" = (/obj/item/trash/can,/turf/simulated/floor/engine/vaulttec{icon_state = "floorrusty"},/area/djstation)
"aI" = (/turf/indestructible/repconn{icon_state = "supermart1"},/area/djstation)
"aJ" = (/obj/structure/mopbucket,/turf/simulated/floor/engine/vaulttec{icon_state = "bluedirtychess"},/area/djstation)
"aK" = (/obj/machinery/light/small{dir = 1},/obj/item/weapon/mop,/turf/simulated/floor/engine/vaulttec{icon_state = "bluedirtychess"},/area/djstation)
"aL" = (/obj/structure/toilet,/turf/simulated/floor/engine/vaulttec{icon_state = "bluedirtychess"},/area/djstation)
"aM" = (/obj/structure/bookcase/manuals/medical,/turf/simulated/floor/engine/house,/area/djstation)
"aN" = (/obj/structure/table/wood,/obj/structure/mirror{pixel_y = 25},/turf/simulated/floor/engine/house,/area/djstation)
"aO" = (/obj/structure/bookcase/random/nonfiction,/turf/simulated/floor/engine/house,/area/djstation)
"aP" = (/obj/structure/closet/wardrobe/white/medical,/turf/simulated/floor/engine/house,/area/djstation)
"aQ" = (/turf/simulated/floor/engine/house,/area/djstation)
"aR" = (/obj/machinery/light/small{dir = 1},/turf/simulated/floor/engine/house,/area/djstation)
"aS" = (/obj/effect/decal/clock/oldactive{step_y = 30},/turf/simulated/floor/engine/house,/area/djstation)
"aT" = (/turf/simulated/floor/engine/house{icon_state = "housewood3"},/area/djstation)
"aU" = (/obj/structure/table/wood,/turf/simulated/floor/engine/house,/area/djstation)
"aV" = (/turf/indestructible/robco{icon_state = "storewindowtop"},/area/djstation)
"aW" = (/turf/simulated/floor/engine/vaulttec{icon_state = "floordirty"},/area/djstation)
"aX" = (/obj/structure/table,/turf/simulated/floor/engine/vaulttec{icon_state = "floorrusty"},/area/djstation)
"aY" = (/obj/machinery/dooor/room,/turf/simulated/floor/engine/vaulttec{icon_state = "bluedirtychess"},/area/djstation)
"aZ" = (/turf/simulated/floor/engine/vaulttec{icon_state = "bluedirtychess"},/area/djstation)
"ba" = (/obj/item/trash/deadmouse,/turf/simulated/floor/engine/vaulttec{icon_state = "bluedirtychess"},/area/djstation)
"bb" = (/turf/simulated/floor/engine/house{icon_state = "housewood2"},/area/djstation)
"bc" = (/turf/indestructible/robco{icon_state = "storewindowvertical"},/area/djstation)
"bd" = (/obj/structure/table,/obj/item/weapon/reagent_containers/food/drinks/drinkingglass/shotglass,/turf/simulated/floor/engine/vaulttec{icon_state = "floordirty"},/area/djstation)
"be" = (/obj/structure/table,/obj/item/weapon/lighter/greyscale,/turf/simulated/floor/engine/vaulttec{icon_state = "floorrusty"},/area/djstation)
"bf" = (/obj/structure/table,/obj/item/weapon/reagent_containers/food/drinks/drinkingglass/shotglass,/turf/simulated/floor/engine/vaulttec{icon_state = "floorrusty"},/area/djstation)
"bg" = (/obj/structure/table,/obj/item/weapon/reagent_containers/food/drinks/nukacola/radioactive,/turf/simulated/floor/engine/vaulttec{icon_state = "floorrusty"},/area/djstation)
"bh" = (/turf/indestructible/repconn{icon_state = "supermart2"},/area/djstation)
"bi" = (/obj/structure/table,/obj/item/weapon/light/tube,/turf/simulated/floor/engine/vaulttec{icon_state = "bluedirtychess"},/area/djstation)
"bj" = (/obj/structure/sink{dir = 4; step_x = 15; step_y = 5},/obj/structure/mirror{pixel_x = 30},/turf/simulated/floor/engine/vaulttec{icon_state = "bluedirtychess"},/area/djstation)
"bk" = (/turf/indestructible/repconn{icon_state = "wasteland3alt"},/area/djstation)
"bl" = (/obj/structure/bed/chair/comfy/brown{dir = 4},/turf/simulated/floor/engine/house{icon_state = "housewood2"},/area/djstation)
"bm" = (/turf/simulated/floor/engine/house{icon_state = "housewood1-broken"},/area/djstation)
"bn" = (/obj/structure/bed/chair/wood/worn{dir = 4},/turf/simulated/floor/engine/house,/area/djstation)
"bo" = (/obj/structure/table/wood,/turf/simulated/floor/engine/house{icon_state = "housewood3"},/area/djstation)
"bp" = (/obj/structure/bed/chair/wood/worn{dir = 8},/turf/simulated/floor/engine/house,/area/djstation)
"bq" = (/turf/indestructible/robco{icon_state = "storewindowbottom"},/area/djstation)
"br" = (/obj/structure/bed/stool/red,/turf/simulated/floor/engine/vaulttec{icon_state = "floorrusty"},/area/djstation)
"bs" = (/obj/structure/bed/stool/red,/turf/simulated/floor/engine/vaulttec{icon_state = "floordirty"},/area/djstation)
"bt" = (/turf/indestructible/repconn{icon_state = "supermart7"},/area/djstation)
"bu" = (/turf/indestructible/repconn{icon_state = "supermart11"},/area/djstation)
"bv" = (/obj/structure/table/wood,/turf/simulated/floor/engine/house{icon_state = "housewood2"},/area/djstation)
"bw" = (/turf/simulated/floor/engine/house{icon_state = "housewood2-broken"},/area/djstation)
"bx" = (/obj/structure/bed/chair/wood/worn{dir = 4},/turf/simulated/floor/engine/house{icon_state = "housewood3"},/area/djstation)
"by" = (/obj/structure/table/wood,/obj/item/trash/candle,/turf/simulated/floor/engine/house,/area/djstation)
"bz" = (/obj/structure/bed/chair/wood/worn{dir = 8},/turf/simulated/floor/engine/house{icon_state = "housewood2"},/area/djstation)
"bA" = (/obj/machinery/light{dir = 8},/turf/simulated/floor/engine/vaulttec{icon_state = "floorrusty"},/area/djstation)
"bB" = (/obj/item/weapon/cigbutt,/turf/simulated/floor/engine/vaulttec{icon_state = "floorrusty"},/area/djstation)
"bC" = (/obj/machinery/light{dir = 4},/turf/simulated/floor/engine/vaulttec{icon_state = "floorrusty"},/area/djstation)
"bD" = (/obj/structure/rack,/turf/simulated/floor/engine/vaulttec{icon_state = "floorrusty"},/area/djstation)
"bE" = (/obj/structure/closet/cabinet,/turf/simulated/floor/engine/vaulttec{icon_state = "floordirty"},/area/djstation)
"bF" = (/obj/machinery/light/small,/turf/simulated/floor/engine/house,/area/djstation)
"bG" = (/obj/structure/fence/fencenormal,/turf/simulated/floor/engine/housebase{dir = 8; icon_state = "outerpavement"},/area/djstation)
"bH" = (/obj/structure/fence/fencedoor,/turf/simulated/floor/engine/wasteland,/area/djstation)
"bI" = (/obj/structure/fence/fencenormal,/turf/simulated/floor/engine/housebase{dir = 4; icon_state = "outerpavement"},/area/djstation)
"bJ" = (/obj/structure/piano,/turf/simulated/floor/engine/vaulttec{icon_state = "floordirty"},/area/djstation)
"bK" = (/obj/structure/bed/chair/wood/normal{dir = 8},/turf/simulated/floor/engine/vaulttec{icon_state = "floordirty"},/area/djstation)
"bL" = (/obj/machinery/dooor/glass,/turf/simulated/floor/engine/vaulttec{icon_state = "floorrusty"},/area/djstation)
"bM" = (/obj/machinery/light/small{dir = 4},/turf/simulated/floor/engine/vaulttec{icon_state = "floordirty"},/area/djstation)
"bN" = (/turf/indestructible/robco{icon_state = "wastelandwindowbroken"},/area/djstation)
"bO" = (/obj/machinery/dooor/wood,/turf/simulated/floor/engine/house,/area/djstation)
"bP" = (/obj/effect/decal/decoration,/turf/indestructible/robco,/area/djstation)
"bQ" = (/obj/structure/bed/chair/comfy/brown,/turf/simulated/floor/engine/vaulttec{icon_state = "floorrusty"},/area/djstation)
"bR" = (/obj/item/weapon/broken_bottle,/turf/simulated/floor/engine/vaulttec{icon_state = "floorrusty"},/area/djstation)
"bS" = (/obj/structure/table/wood,/turf/simulated/floor/engine/vaulttec{icon_state = "floorrusty"},/area/djstation)
"bT" = (/obj/structure/table/wood,/obj/item/weapon/book/manual/barman_recipes,/turf/simulated/floor/engine/vaulttec{icon_state = "floorrusty"},/area/djstation)
"bU" = (/turf/simulated/floor/engine/housebase{dir = 4; icon_state = "outerpavementcorner"},/area/djstation)
"bV" = (/turf/simulated/floor/engine/housebase{dir = 1; icon_state = "outerpavement"},/area/djstation)
"bW" = (/turf/simulated/floor/engine/housebase{dir = 5; icon_state = "outerpavement"},/area/djstation)
"bX" = (/turf/simulated/floor/engine/road,/area/djstation)
"bY" = (/turf/simulated/floor/engine/housebase{dir = 9; icon_state = "outerpavement"},/area/djstation)
"bZ" = (/turf/simulated/floor/engine/housebase{dir = 1; icon_state = "outerpavementcorner"},/area/djstation)
"ca" = (/obj/structure/table/wood,/obj/machinery/light{dir = 8},/turf/simulated/floor/engine/vaulttec{icon_state = "floorrusty"},/area/djstation)
"cb" = (/obj/structure/table/wood,/obj/item/weapon/reagent_containers/food/snacks/kebab,/turf/simulated/floor/engine/vaulttec{icon_state = "floordirty"},/area/djstation)
"cc" = (/obj/structure/table/wood,/obj/machinery/light{dir = 4},/turf/simulated/floor/engine/vaulttec{icon_state = "floordirty"},/area/djstation)
"cd" = (/obj/machinery/light/small{dir = 4},/turf/simulated/floor/engine/vaulttec{icon_state = "floorrusty"},/area/djstation)
"ce" = (/obj/structure/bed/chair/comfy/brown{dir = 1},/turf/simulated/floor/engine/vaulttec{icon_state = "floorrusty"},/area/djstation)
"cf" = (/obj/structure/bed,/obj/item/weapon/bedsheet/red,/turf/simulated/floor/engine/vaulttec{icon_state = "floordirty"},/area/djstation)
"cg" = (/obj/structure/table/wood,/obj/item/device/harmonica,/turf/simulated/floor/engine/vaulttec{icon_state = "floorrusty"},/area/djstation)
"ch" = (/obj/structure/bed,/obj/item/weapon/bedsheet/yellow,/turf/simulated/floor/engine/vaulttec{icon_state = "floordirty"},/area/djstation)
"ci" = (/turf/indestructible/repconn{icon_state = "supermart5"},/area/djstation)
"cj" = (/turf/indestructible/repconn{icon_state = "supermart8"},/area/djstation)
"ck" = (/obj/machinery/dooor/house,/turf/simulated/floor/engine/vaulttec{icon_state = "floorrustysolid"},/area/djstation)
"cl" = (/turf/indestructible/repconn{icon_state = "supermart4"},/area/djstation)
"cm" = (/turf/indestructible/repconn{icon_state = "supermart13"},/area/djstation)
"cn" = (/turf/simulated/floor/engine/road{icon_state = "horizontaltopbordertop3"},/area/djstation)
"co" = (/turf/simulated/floor/engine/road{icon_state = "horizontaltopbordertop2"},/area/djstation)
"cp" = (/turf/simulated/floor/engine/road{icon_state = "horizontaltopbordertop1"},/area/djstation)
"cq" = (/turf/simulated/floor/engine/road{icon_state = "horizontaltopbordertop0"},/area/djstation)
"cr" = (/turf/simulated/floor/engine/road{dir = 8; icon_state = "tinycornerhorizontal"},/area/djstation)
"cs" = (/obj/machinery/light/small{dir = 4},/turf/simulated/floor/engine/road,/area/djstation)
"ct" = (/obj/machinery/vending/nukacolavend,/turf/simulated/floor/engine/house,/area/djstation)
"cu" = (/obj/effect/decal/sign{desc = "Remove kebab."; icon_state = "vault_kebab"; name = "kebab sign"; pixel_x = -10; pixel_y = 29},/turf/simulated/floor/engine/house,/area/djstation)
"cv" = (/obj/machinery/light/small{dir = 1},/turf/simulated/floor/engine/house{icon_state = "housewood3"},/area/djstation)
"cw" = (/obj/structure/noticeboard{pixel_y = 32},/turf/simulated/floor/engine/house,/area/djstation)
"cx" = (/obj/structure/fireaxecabinet{pixel_y = 30},/turf/simulated/floor/engine/house{icon_state = "housewood2"},/area/djstation)
"cy" = (/obj/structure/filingcabinet/chestdrawer,/turf/simulated/floor/engine/house,/area/djstation)
"cz" = (/turf/simulated/floor/engine/road{icon_state = "horizontaltopborderbottom2"},/area/djstation)
"cA" = (/turf/simulated/floor/engine/road{icon_state = "horizontaltopborderbottom1"},/area/djstation)
"cB" = (/obj/effect/decal/hatch{dir = 1},/turf/simulated/floor/engine/road{icon_state = "horizontaltopborderbottom1"},/area/djstation)
"cC" = (/turf/simulated/floor/engine/road{icon_state = "horizontaltopborderbottom0"},/area/djstation)
"cD" = (/turf/simulated/floor/engine/road{dir = 4; icon_state = "innerturn"},/area/djstation)
"cE" = (/turf/simulated/floor/engine/road{dir = 8; icon_state = "tinycornervertical"},/area/djstation)
"cF" = (/obj/item/weapon/cigbutt,/turf/simulated/floor/engine/housebase{icon_state = "outerpavement"},/area/djstation)
"cG" = (/obj/structure/table/wood,/obj/item/weapon/phone,/turf/simulated/floor/engine/house,/area/djstation)
"cH" = (/turf/simulated/floor/engine/road{icon_state = "horizontalinnermain1"},/area/djstation)
"cI" = (/turf/simulated/floor/engine/road{icon_state = "horizontalinnermain2"},/area/djstation)
"cJ" = (/turf/simulated/floor/engine/road{icon_state = "horizontalinnermain0"},/area/djstation)
"cK" = (/turf/simulated/floor/engine/road{icon_state = "verticalrightborderright1"},/area/djstation)
"cL" = (/obj/machinery/dooor/store,/turf/simulated/floor/engine/house,/area/djstation)
"cM" = (/obj/structure/table/wood,/obj/item/toy/redbutton,/turf/simulated/floor/engine/house,/area/djstation)
"cN" = (/turf/indestructible/corvega,/area/djstation)
"cO" = (/turf/simulated/floor/engine/road{icon_state = "verticalinnermainbottom"},/area/djstation)
"cP" = (/turf/simulated/floor/engine/road{dir = 8; icon_state = "innermaincornerinner"},/area/djstation)
"cQ" = (/turf/simulated/floor/engine/road{icon_state = "hole"},/area/djstation)
"cR" = (/turf/simulated/floor/engine/road{icon_state = "verticalrightborderright0"},/area/djstation)
"cS" = (/obj/effect/decal/cleanable/blood/old,/turf/simulated/floor/engine/road,/area/djstation)
"cT" = (/obj/structure/bed/stool,/turf/simulated/floor/engine/house{icon_state = "housewood2"},/area/djstation)
"cU" = (/turf/simulated/floor/engine/road{dir = 8; icon_state = "innermaincornerouter"},/area/djstation)
"cV" = (/turf/simulated/floor/engine/road{icon_state = "horizontalinnermainleft"},/area/djstation)
"cW" = (/obj/structure/closet/crate/bin,/turf/simulated/floor/engine/house,/area/djstation)
"cX" = (/obj/structure/table,/obj/item/clothing/head/helmet/f13/eyebot,/turf/simulated/floor/engine/house,/area/djstation)
"cY" = (/turf/simulated/floor/engine/road{dir = 4; icon_state = "innermaincornerinner"},/area/djstation)
"cZ" = (/turf/simulated/floor/engine/road{icon_state = "verticalinnermaintop"},/area/djstation)
"da" = (/turf/simulated/floor/engine/road{dir = 1; icon_state = "innermaincornerinner"},/area/djstation)
"db" = (/turf/simulated/floor/engine/road{dir = 2; icon_state = "innermaincornerinner"},/area/djstation)
"dc" = (/obj/machinery/dooor/room,/turf/simulated/floor/engine/vaulttec{icon_state = "floordirtysolid"},/area/djstation)
"dd" = (/turf/indestructible/repconn{icon_state = "storeprewindowtop"},/area/djstation)
"de" = (/obj/structure/table/wood,/turf/simulated/floor/engine/vaulttec{icon_state = "floordirty"},/area/djstation)
"df" = (/obj/structure/bookcase/random/reference,/turf/simulated/floor/engine/vaulttec{icon_state = "floorrusty"},/area/djstation)
"dg" = (/obj/structure/bookcase/random/nonfiction,/turf/simulated/floor/engine/vaulttec{icon_state = "floorrusty"},/area/djstation)
"dh" = (/obj/structure/rack,/turf/simulated/floor/engine/vaulttec{icon_state = "floordirty"},/area/djstation)
"di" = (/obj/structure/dresser,/obj/structure/mirror{pixel_y = 25},/turf/simulated/floor/engine/vaulttec{icon_state = "floorrusty"},/area/djstation)
"dj" = (/obj/structure/bed,/obj/item/weapon/bedsheet/brown,/turf/simulated/floor/engine/vaulttec{icon_state = "floordirty"},/area/djstation)
"dk" = (/obj/structure/table/wood,/obj/item/weapon/reagent_containers/food/drinks/bottle/cognac,/turf/simulated/floor/engine/vaulttec{icon_state = "floordirty"},/area/djstation)
"dl" = (/obj/structure/closet/cabinet,/turf/simulated/floor/engine/vaulttec{icon_state = "floorrusty"},/area/djstation)
"dm" = (/obj/machinery/light{dir = 4},/turf/simulated/floor/engine/vaulttec{icon_state = "floordirty"},/area/djstation)
"dn" = (/turf/simulated/floor/engine/road{icon_state = "horizontalbottombordertop1"},/area/djstation)
"do" = (/turf/simulated/floor/engine/road{icon_state = "horizontalbottombordertop2"},/area/djstation)
"dp" = (/obj/effect/decal/hatch,/turf/simulated/floor/engine/road{icon_state = "horizontalbottombordertop0"},/area/djstation)
"dq" = (/turf/simulated/floor/engine/road{icon_state = "horizontalbottombordertop0"},/area/djstation)
"dr" = (/turf/simulated/floor/engine/road{icon_state = "innerturn"},/area/djstation)
"ds" = (/turf/simulated/floor/engine/road{dir = 1; icon_state = "tinycornervertical"},/area/djstation)
"dt" = (/obj/structure/bed/chair/comfy/black,/turf/simulated/floor/engine/vaulttec{icon_state = "floorrusty"},/area/djstation)
"du" = (/turf/simulated/floor/engine/road{icon_state = "horizontalbottomborderbottom0"},/area/djstation)
"dv" = (/turf/simulated/floor/engine/road{icon_state = "horizontalbottomborderbottom1"},/area/djstation)
"dw" = (/turf/simulated/floor/engine/road{icon_state = "horizontalbottomborderbottom2"},/area/djstation)
"dx" = (/turf/simulated/floor/engine/road{dir = 1; icon_state = "tinycornerhorizontal"},/area/djstation)
"dy" = (/obj/structure/bed/chair/comfy/black{dir = 4},/turf/simulated/floor/engine/vaulttec{icon_state = "floorrusty"},/area/djstation)
"dz" = (/obj/structure/table,/obj/item/weapon/lighter/engraved,/turf/simulated/floor/engine/vaulttec{icon_state = "floorrusty"},/area/djstation)
"dA" = (/obj/structure/bed/chair/comfy/black{dir = 8},/turf/simulated/floor/engine/vaulttec{icon_state = "floordirty"},/area/djstation)
"dB" = (/obj/machinery/dooor/brokenglass,/turf/simulated/floor/engine/vaulttec{icon_state = "floorrusty"},/area/djstation)
"dC" = (/turf/indestructible/repconn{icon_state = "storeprewindowvertical"},/area/djstation)
"dD" = (/obj/structure/table,/obj/item/weapon/coin/silver,/turf/simulated/floor/engine/vaulttec{icon_state = "floorrusty"},/area/djstation)
"dE" = (/obj/structure/bed/chair/comfy/black{dir = 8},/turf/simulated/floor/engine/vaulttec{icon_state = "floorrusty"},/area/djstation)
"dF" = (/obj/structure/bed/chair/wood/worn{dir = 4},/turf/simulated/floor/engine/vaulttec{icon_state = "floordirty"},/area/djstation)
"dG" = (/obj/structure/table,/turf/simulated/floor/engine/vaulttec{icon_state = "floordirty"},/area/djstation)
"dH" = (/obj/structure/bed,/obj/item/weapon/gun/projectile/automatic/pistol,/obj/item/weapon/bedsheet/patriot,/turf/simulated/floor/engine/vaulttec{icon_state = "floorrusty"},/area/djstation)
"dI" = (/obj/structure/bed/chair/comfy/black{dir = 1},/turf/simulated/floor/engine/vaulttec{icon_state = "floorrusty"},/area/djstation)
"dJ" = (/obj/structure/table,/obj/structure/bedsheetbin,/turf/simulated/floor/engine/vaulttec{icon_state = "bluedirtychess"},/area/djstation)
"dK" = (/obj/structure/sink{layer = 3.1; step_y = 20},/obj/structure/mirror{layer = 3; pixel_y = 30},/turf/simulated/floor/engine/vaulttec{icon_state = "bluedirtychess"},/area/djstation)
"dL" = (/obj/structure/table,/obj/item/weapon/lipstick,/turf/simulated/floor/engine/vaulttec{icon_state = "bluedirtychess"},/area/djstation)
"dM" = (/turf/simulated/floor/engine/road{dir = 2; icon_state = "outermaincornerouter"},/area/djstation)
"dN" = (/turf/simulated/floor/engine/road{dir = 8; icon_state = "outermaincornerouter"},/area/djstation)
"dO" = (/obj/structure/flora/tree/wasteland,/turf/simulated/floor/engine/wasteland,/area/djstation)
"dP" = (/obj/structure/table,/obj/item/weapon/switchblade,/turf/simulated/floor/engine/vaulttec{icon_state = "floorrusty"},/area/djstation)
"dQ" = (/obj/structure/bed/stool/blue,/turf/simulated/floor/engine/vaulttec{icon_state = "bluedirtychess"},/area/djstation)
"dR" = (/turf/simulated/floor/engine/road{dir = 4; icon_state = "outermaincornerouter"},/area/djstation)
"dS" = (/turf/simulated/floor/engine/road{dir = 1; icon_state = "outermaincornerouter"},/area/djstation)
"dT" = (/turf/indestructible/repconn{icon_state = "storeprewindowbottom"},/area/djstation)
"dU" = (/obj/structure/filingcabinet/filingcabinet,/turf/simulated/floor/engine/vaulttec{icon_state = "floordirty"},/area/djstation)
"dV" = (/obj/structure/bed/chair/office/blue{dir = 1},/turf/simulated/floor/engine/vaulttec{icon_state = "floorrusty"},/area/djstation)
"dW" = (/obj/machinery/light,/turf/simulated/floor/engine/vaulttec{icon_state = "floorrusty"},/area/djstation)
"dX" = (/obj/machinery/light/small,/turf/simulated/floor/engine/vaulttec{icon_state = "bluedirtychess"},/area/djstation)
"dY" = (/obj/structure/toilet{dir = 8},/turf/simulated/floor/engine/vaulttec{icon_state = "bluedirtychess"},/area/djstation)
"dZ" = (/turf/indestructible/repconn{icon_state = "supermart9"},/area/djstation)

(1,1,1) = {"
aaaaaaaaaaaaaaaaaaaaaaaaaaaaaaaaaaaaaaaaaaaaaaaaaaaaaaaaaaaa
aaababacadaeaeaeaeaeafagabababahaiaiaiaiaiaiaiaiaiaiaiaiaiaa
aaahaiajakalamamanaoafapaiaqaracasatauavavavawaxayazazazaAaa
aaacaBaCaBaCaCaDaCaCaBaCaBagabacaEaFaGaHaGaGaGaFaIaJaKaLaEaa
aaacafaMaNaOaPaQaRaSaTaUafagabacaVaGaGaWaGaXaWaWaYaZaZbaaEaa
aaacafaQaTbbbbaQaTaQbbbbafagabacbcaGbdbebfbgaGaWbhbiaZbjaEaa
aaacbkblaQbmaQaQbbbnbobpbkagabacbqaGbrbsbrbraGaGbtazazazbuaa
aaacafbvboaTaQaQbwbxbybzafagabacaEbAaGaGaWaWbBbCaIbDbDbEaEaa
aaacafaQaQbFaTaQaQbFaQaQafbGbHbIaEbJbKaGaGaGaWaGbLaWaGbMaEaa
aaacaBaCbNaCaBbOaBaCbPaCaBagabacaEbQbQaWbRaGaGaGbhaGbSbTaEaa
aabUbVbVbVbVbWbXbYbVbVbVbVbZabacaEcacbaWaWaGaGccaEaGaWcdaEaa
aaababarababacbXagababababababacaEceceaGaWaGaGceaEcfcgchaEaa
aaaiaiaiaiaiajbXapaiaiaiaqarabacciazayazcjckclazcmazazazbuaa
aacncocpcqcpcpcqcqcqcrbXagababacbXcsaEctcuaQaQcvcwaQcxcyaEaa
aaczcAcAcAczcBcCcCcCcDcEapaicFajbXbXaIaQbbaTaQbmaUcGaQaTaEaa
aacHcIcHcHcHcHcHcJcJcJcKbXbXbXbXbXbXcLaQbbbbbbaTcMbpaQbbcNaa
aacOcOcPcJcJcQcHcHcHcJcRbYbVbVbWcSbXbhbbbwbbaQaQaUaUaTcTaEaa
aacUabcVcHcJcHcIcHcHcJcRagababacbXcsaEcWaQaQaQbFaQbbbbcXaEaa
aacYcZdacHcHdbcOcPcIcHcRagababacasazcmazcjdcclazayazazazbuaa
aacJcHcHcHcIcYcZdacHcIcKagababacdddedfdgdhaWaWdiaEdjdkdlaEaa
aacQcHcHcHcHcHcIcHcHcHcRagababacaVaGaGaWaGaWaGdmaEaGaGcdaEaa
aadncHdodncHdpdqdqdqdrdsagabaracbcaWaWdtdtaGaGaWaIaWaGaWaEaa
aadudvdwdvdudududududxbXagababacbqaWdybddzdAaGaGdBaGaGbMaEaa
aabVbVbVbVbVbVbVbVbVbVbVbZababacdCaWdydDaXdEaGaWbhdFdGdHaEaa
aaababababababababababababababacaVaWaGdIdIaGaWbCbtazazazbuaa
aaabarababababababababababababacbcaWaWaGaWaGaGaGaIdJdKdLaEaa
aaabababdMdNabababababdOabababacbqdPdGaXaGaWaGaWaYaZaZdQaEaa
aaabababdRdSabarabababababababacdTdUdVdWaGdWaWaGbhaZdXdYaEaa
aaababababababababababababababacciazazazazazazazcmazazazdZaa
aaaaaaaaaaaaaaaaaaaaaaaaaaaaaaaaaaaaaaaaaaaaaaaaaaaaaaaaaaaa
"}
