//MAP CONVERTED BY dmm2tgm.py THIS HEADER COMMENT PREVENTS RECONVERSION, DO NOT REMOVE
"a" = (
/turf/closed/indestructible/rock/ms13,
/area/space)
"b" = (
/turf/closed/wall/r_wall/ms13/bunker,
/area/space)
"c" = (
/turf/open/floor/plasteel,
/area/space)
"d" = (
/obj/machinery/porta_turret/syndicate,
/turf/open/floor/plasteel,
/area/space)
"e" = (
/obj/structure/table/low_wall/reinforced/bunker,
/obj/structure/window/fulltile/ms13/glass,
/turf/open/floor/plasteel,
/area/space)
"f" = (
/obj/structure/table/reinforced,
/turf/open/floor/plasteel,
/area/space)
"g" = (
/turf/open/floor/plating,
/area/space)
"h" = (
/turf/open/floor/wood/ms13,
/area/space)
"i" = (
/obj/structure/table/reinforced,
/turf/open/floor/wood/ms13,
/area/space)
"j" = (
/obj/structure/target_stake,
/obj/item/target,
/turf/open/floor/plasteel,
/area/space)
"k" = (
/obj/structure/frame/machine,
/turf/open/floor/plasteel,
/area/space)
"l" = (
/obj/machinery/door/poddoor/shutters,
/turf/open/floor/plasteel,
/area/space)
"m" = (
/obj/structure/table/reinforced,
/obj/structure/table/reinforced,
/turf/open/floor/plasteel,
/area/space)
"n" = (
/obj/machinery/door/airlock/highsecurity,
/turf/open/floor/plasteel,
/area/space)
"o" = (
/obj/structure/table/low_wall/reinforced/bunker,
/turf/open/floor/plasteel,
/area/space)
"p" = (
/obj/structure/table/reinforced,
/obj/structure/table/reinforced,
/obj/structure/table/reinforced,
/turf/open/floor/plasteel,
/area/space)
"w" = (
/obj/effect/decal/cleanable/glass,
/turf/open/floor/plasteel,
/area/space)

(1,1,1) = {"
a
a
a
a
a
a
a
a
a
a
a
a
a
a
a
a
a
a
a
a
a
a
a
a
a
a
a
a
a
a
a
a
a
a
a
a
a
a
a
a
a
a
a
a
a
a
a
a
a
a
a
a
a
a
a
a
a
a
a
a
a
a
a
a
a
a
a
a
a
a
a
a
a
a
b
b
b
b
b
b
b
b
b
b
b
b
b
a
a
a
a
a
a
a
a
a
a
a
a
a
"}
(2,1,1) = {"
a
a
a
a
a
a
a
a
a
a
a
a
a
a
a
a
a
a
a
a
a
a
a
a
a
a
a
a
a
a
a
a
a
a
a
a
a
a
a
a
a
a
a
a
a
a
a
a
a
a
a
a
a
a
a
a
a
a
a
a
a
a
a
a
a
a
a
a
a
a
a
a
a
a
b
c
c
c
c
c
b
c
b
c
b
c
b
a
a
a
a
a
a
a
a
a
a
a
a
a
"}
(3,1,1) = {"
a
a
a
a
a
a
a
b
b
b
b
b
b
b
b
b
b
b
b
b
b
b
b
a
a
a
a
a
a
a
a
a
a
a
a
a
a
a
a
a
a
a
a
a
a
a
a
a
a
a
a
a
a
a
a
a
a
a
a
a
a
a
a
a
a
a
a
a
a
a
a
a
a
a
b
c
c
c
c
c
b
c
b
c
b
c
b
a
a
a
a
a
a
a
a
a
a
a
a
a
"}
(4,1,1) = {"
a
a
a
a
a
a
a
b
h
h
h
h
h
h
h
h
h
h
h
h
h
h
b
a
a
a
a
a
a
a
a
a
a
a
a
a
a
a
a
a
a
a
a
a
a
a
a
a
a
a
a
a
a
a
a
a
a
a
a
a
a
a
a
a
a
a
a
a
a
a
a
a
a
a
b
c
c
c
c
c
c
c
c
c
c
c
b
a
a
a
a
a
a
a
a
a
a
a
a
a
"}
(5,1,1) = {"
a
a
a
a
a
a
a
b
h
h
h
h
h
h
h
h
h
h
h
h
h
h
b
a
a
a
a
a
a
a
a
a
a
a
a
a
a
a
a
a
a
a
a
a
a
a
a
a
a
a
a
a
a
a
a
a
a
a
a
a
a
a
a
a
a
a
a
a
a
a
a
a
a
a
b
c
c
c
c
c
c
c
c
c
c
c
b
a
a
a
a
a
a
a
a
a
a
a
a
a
"}
(6,1,1) = {"
a
a
b
b
b
b
b
b
h
h
b
b
b
b
h
h
b
b
b
b
h
h
b
b
b
b
b
b
b
b
b
b
b
b
b
b
b
b
b
b
b
b
b
b
b
b
b
b
b
b
b
b
b
b
b
b
b
b
b
b
b
b
b
b
b
b
b
b
b
b
b
b
b
b
b
b
b
c
b
b
b
b
b
b
b
b
b
b
b
b
b
b
b
b
b
b
b
b
b
b
"}
(7,1,1) = {"
a
a
b
h
h
h
h
b
h
h
b
h
h
h
h
h
h
h
h
b
h
h
b
h
h
h
h
b
c
c
c
b
c
c
c
c
c
c
c
c
c
c
c
c
c
c
c
c
c
c
c
c
c
c
c
c
c
c
c
b
c
c
b
c
c
c
c
c
c
c
c
c
c
c
c
c
c
c
c
c
c
c
c
c
c
c
c
c
c
c
c
c
c
c
c
c
c
c
c
b
"}
(8,1,1) = {"
a
a
b
h
h
h
h
h
h
h
b
h
h
h
h
h
h
h
h
b
h
h
h
h
h
h
h
b
c
c
c
c
c
c
c
c
c
c
c
c
c
c
c
c
c
c
c
c
c
c
c
c
c
c
c
c
c
c
c
b
c
c
b
c
c
c
c
c
c
c
c
c
c
c
c
c
c
c
c
c
c
c
c
c
c
c
c
c
c
c
c
c
c
c
c
c
c
c
c
b
"}
(9,1,1) = {"
a
a
b
h
h
h
h
b
h
h
b
b
h
b
b
b
b
b
b
b
h
h
b
h
h
h
h
b
c
c
c
b
c
c
c
c
c
c
c
c
c
c
c
c
c
c
c
c
c
c
c
c
c
c
c
c
c
c
c
c
c
c
b
c
c
c
c
b
b
c
b
b
b
c
b
b
b
c
b
b
b
c
b
b
b
c
b
b
b
c
b
b
b
c
b
b
b
c
b
b
"}
(10,1,1) = {"
a
a
b
b
b
b
b
b
h
h
b
h
h
h
h
h
h
h
h
b
h
h
b
b
b
b
b
b
b
b
b
b
c
c
c
c
c
c
c
b
b
b
b
b
b
b
b
b
c
c
c
c
c
c
c
c
c
c
c
c
c
c
b
c
c
c
c
b
c
c
c
b
c
c
c
b
c
c
c
b
c
c
c
b
c
c
c
b
c
c
c
b
c
c
c
b
c
c
c
b
"}
(11,1,1) = {"
a
a
b
h
h
h
h
b
h
h
b
h
h
h
h
h
h
h
h
b
h
h
b
h
h
h
h
b
c
c
c
b
c
c
c
c
c
c
c
b
c
c
c
c
c
c
c
b
c
b
b
c
b
b
c
b
b
c
c
b
c
c
b
c
c
c
c
b
c
c
c
b
c
c
c
b
c
c
c
b
c
c
c
b
c
c
c
b
c
c
c
b
c
c
c
b
c
c
c
b
"}
(12,1,1) = {"
a
a
b
h
h
h
h
h
h
h
b
h
h
h
h
h
h
h
h
b
h
h
h
h
h
h
h
b
c
c
c
c
c
c
c
c
c
c
c
b
c
c
c
c
c
c
c
b
c
c
b
c
c
b
c
c
b
c
c
b
c
c
b
c
c
c
c
b
c
c
c
b
c
c
c
b
c
c
c
b
c
c
c
b
c
c
c
b
c
c
c
b
c
c
c
b
c
c
c
b
"}
(13,1,1) = {"
a
a
b
h
h
h
h
b
h
h
b
h
h
h
h
h
h
h
h
b
h
h
b
h
h
h
h
b
c
c
c
b
c
c
c
c
c
c
c
c
c
c
c
c
c
c
c
b
c
c
b
c
c
b
c
c
b
c
c
c
c
c
b
c
c
c
c
b
b
b
b
b
b
b
b
b
b
b
b
b
b
b
b
b
b
b
b
b
b
b
b
b
b
b
b
b
b
b
b
b
"}
(14,1,1) = {"
a
a
b
b
b
b
b
b
h
h
b
h
h
h
h
b
b
b
b
b
h
h
b
b
b
b
b
b
b
b
b
b
c
c
c
c
c
c
c
b
c
c
c
c
c
c
c
b
c
c
b
c
c
b
c
c
b
c
c
b
c
c
b
c
c
c
c
b
a
a
a
a
a
a
a
a
a
a
a
a
a
a
a
a
a
a
a
a
a
a
a
a
a
a
a
a
a
a
a
a
"}
(15,1,1) = {"
a
a
b
h
h
h
h
b
h
h
b
h
h
h
h
b
h
h
h
b
h
h
b
h
h
h
h
b
c
c
c
b
c
c
c
c
c
c
c
b
b
b
b
b
b
b
b
b
b
b
b
b
b
b
b
b
b
c
c
b
c
c
b
c
c
c
c
b
a
a
a
a
a
a
a
a
a
a
a
a
a
a
a
a
a
a
a
a
a
a
a
a
a
a
a
a
a
a
a
a
"}
(16,1,1) = {"
a
a
b
h
h
h
h
h
h
h
b
h
h
h
h
b
h
h
h
b
h
h
h
h
h
h
h
b
c
c
c
c
c
c
c
c
c
c
c
b
f
f
f
f
b
c
c
b
c
c
b
c
c
b
c
c
b
c
c
b
b
b
b
c
c
c
c
b
a
a
a
a
a
a
a
a
a
a
a
a
a
a
a
a
a
a
a
a
a
a
a
a
a
a
a
a
a
a
a
a
"}
(17,1,1) = {"
a
a
b
h
h
h
h
b
h
h
b
h
h
h
h
h
h
h
h
b
h
h
b
h
h
h
h
b
c
c
c
b
c
c
c
c
c
c
c
b
c
c
c
f
b
c
c
b
c
c
b
c
c
b
c
c
b
c
c
c
c
c
b
c
c
c
c
b
b
b
b
b
b
b
b
b
b
b
b
b
b
b
b
b
b
b
b
b
b
b
b
b
b
b
b
b
b
b
b
b
"}
(18,1,1) = {"
a
a
b
b
b
b
b
b
h
h
b
b
b
b
b
b
b
b
b
b
h
h
b
b
b
b
b
b
b
b
b
b
c
c
c
c
c
c
c
b
c
c
c
f
b
c
c
b
c
c
b
c
c
b
c
c
b
c
c
c
c
c
b
c
c
c
c
b
c
c
c
b
c
c
c
b
c
c
c
b
c
c
c
b
c
c
c
b
c
c
c
b
c
c
c
b
c
c
c
b
"}
(19,1,1) = {"
a
a
a
a
a
a
b
h
h
h
h
h
h
h
h
h
h
h
h
h
h
h
b
h
h
h
h
b
c
c
c
c
c
c
c
c
c
c
c
b
c
c
c
c
c
c
c
c
c
c
c
c
c
c
c
c
c
c
c
c
c
c
b
c
c
c
c
b
c
c
c
b
c
c
c
b
c
c
c
b
c
c
c
b
c
c
c
b
c
c
c
b
c
c
c
b
c
c
c
b
"}
(20,1,1) = {"
a
a
a
a
a
a
b
h
h
h
h
h
h
h
h
h
h
h
h
h
h
h
b
h
h
h
h
b
c
c
c
c
c
c
c
c
c
c
c
b
c
c
c
c
c
c
c
c
c
c
c
c
c
c
c
c
c
c
c
c
c
c
b
c
c
c
c
b
c
c
c
b
c
c
c
b
c
c
c
b
c
c
c
b
c
c
c
b
c
c
c
b
c
c
c
b
c
c
c
b
"}
(21,1,1) = {"
a
a
a
a
a
a
b
h
h
h
h
h
h
h
h
h
h
h
h
h
h
h
b
h
h
h
h
b
c
c
c
b
b
b
b
b
b
b
n
b
f
f
c
c
c
c
c
c
c
c
c
c
c
c
c
c
c
c
c
c
c
c
b
c
c
c
c
b
b
c
b
b
b
c
b
b
b
c
b
b
b
c
b
b
b
c
b
b
b
c
b
b
b
c
b
b
b
c
b
b
"}
(22,1,1) = {"
a
a
a
a
a
a
b
h
h
h
h
h
h
h
h
h
h
h
h
h
h
h
b
h
h
h
h
b
c
c
c
b
c
c
c
c
c
c
c
b
c
c
c
c
c
c
c
c
c
c
c
c
c
c
c
c
c
c
c
c
c
c
b
c
c
c
c
c
c
c
c
c
c
c
c
c
c
c
c
c
c
c
c
c
c
c
c
c
c
c
c
c
c
c
c
c
c
c
c
b
"}
(23,1,1) = {"
a
a
a
a
a
a
b
h
h
h
h
h
h
h
h
h
h
h
h
h
h
h
b
h
h
h
h
b
c
c
c
b
c
c
c
c
c
c
c
l
c
c
c
c
b
c
c
b
c
c
b
c
c
b
c
c
b
c
c
c
c
c
b
c
c
c
c
c
c
c
c
c
c
c
c
c
c
c
c
c
c
c
c
c
c
c
c
c
c
c
c
c
c
c
c
c
c
c
c
b
"}
(24,1,1) = {"
a
a
a
a
a
a
b
h
h
h
h
h
h
h
h
h
h
h
h
h
h
h
b
h
h
h
h
b
c
c
c
b
c
c
c
c
c
c
c
b
c
c
c
c
b
c
c
b
c
c
b
c
c
b
c
c
b
c
c
c
c
c
b
c
c
c
b
b
b
b
b
b
b
b
b
b
b
c
b
b
b
b
b
b
b
b
b
b
b
b
b
b
b
b
b
b
b
b
b
b
"}
(25,1,1) = {"
a
a
a
a
a
a
b
h
h
h
h
h
h
h
h
h
h
b
i
i
h
h
b
h
h
h
h
b
c
c
c
b
c
c
c
c
c
c
c
b
c
c
c
c
b
c
c
b
c
c
b
c
c
b
c
c
b
c
c
c
c
c
b
c
c
c
b
b
a
a
a
a
a
a
b
c
c
c
c
c
c
c
c
c
c
c
b
a
a
a
a
a
a
a
a
a
a
a
a
a
"}
(26,1,1) = {"
a
a
a
a
a
a
b
h
h
h
h
h
h
h
h
h
h
b
h
i
h
h
b
b
b
b
b
b
b
b
b
b
e
e
e
e
b
b
b
b
c
c
b
b
b
b
b
b
b
b
b
b
b
b
b
b
b
b
b
b
b
b
b
c
c
c
b
b
b
a
a
a
a
a
b
c
c
c
c
c
c
c
c
c
c
c
b
a
a
a
a
a
a
a
a
a
a
a
a
a
"}
(27,1,1) = {"
a
a
a
a
a
a
b
h
h
h
h
h
h
h
h
h
h
b
h
i
h
h
h
c
c
c
c
c
c
c
c
l
c
c
c
c
l
c
c
c
c
c
c
c
c
c
c
c
c
c
c
c
c
c
c
c
c
c
c
c
c
c
e
c
c
c
c
c
b
a
a
a
a
a
b
c
c
c
c
c
b
c
b
c
b
c
b
a
a
a
a
a
a
a
a
a
a
a
a
a
"}
(28,1,1) = {"
a
a
a
a
a
a
b
h
h
h
h
h
h
h
h
h
h
b
h
i
h
h
h
c
c
c
c
c
c
c
c
l
c
c
c
c
l
c
c
c
c
c
c
c
c
c
c
c
c
c
c
c
c
c
c
c
c
c
c
c
c
c
c
c
c
c
c
c
b
a
a
a
a
a
b
c
c
c
c
c
b
c
b
c
b
c
b
a
a
a
a
a
a
a
a
a
a
a
a
a
"}
(29,1,1) = {"
a
a
a
a
a
a
b
h
h
h
h
h
h
h
h
h
h
b
h
i
h
h
h
c
c
c
c
c
c
c
c
l
c
c
c
c
l
c
c
c
c
c
c
c
c
c
c
c
c
c
c
c
c
c
c
c
c
c
c
c
c
c
e
c
c
c
c
c
b
a
a
a
a
a
b
b
b
b
b
b
b
b
b
b
b
b
b
a
a
a
a
a
a
a
a
a
a
a
a
a
"}
(30,1,1) = {"
a
a
a
a
a
a
b
h
h
h
h
h
h
h
h
h
h
b
h
i
h
h
b
b
b
b
b
b
b
b
b
b
b
b
b
b
b
b
b
b
b
b
b
b
b
b
b
b
b
b
c
b
b
b
b
b
b
b
b
b
b
b
b
b
b
c
c
c
b
a
a
a
a
a
a
a
a
a
a
a
a
a
a
a
a
a
a
a
a
a
a
a
a
a
a
a
a
a
a
a
"}
(31,1,1) = {"
a
a
a
a
a
a
b
h
h
h
h
h
h
h
h
h
h
b
h
i
h
h
b
d
c
c
c
c
c
c
c
c
c
c
d
c
c
d
c
c
c
c
c
c
c
c
c
b
a
b
c
b
a
a
a
a
a
a
a
a
a
a
a
a
b
c
c
c
b
a
a
a
a
a
a
a
a
a
a
a
a
a
a
a
a
a
a
a
a
a
a
a
a
a
a
a
a
a
a
a
"}
(32,1,1) = {"
a
a
a
a
a
a
b
h
h
h
h
h
h
h
h
h
h
h
h
h
h
h
b
c
c
c
c
c
c
c
c
c
c
c
c
c
c
c
c
c
c
c
c
c
c
c
d
b
b
b
c
b
b
b
a
a
a
a
a
a
a
a
a
a
b
c
c
c
b
a
a
a
a
a
a
a
a
a
a
a
a
a
a
a
a
a
a
a
a
a
a
a
a
a
a
a
a
a
a
a
"}
(33,1,1) = {"
a
a
a
a
a
a
b
h
h
h
h
h
h
h
h
h
h
h
h
h
h
h
b
c
c
c
c
c
c
c
c
c
c
c
c
c
c
c
c
c
c
c
c
c
c
c
c
b
c
c
c
c
c
b
a
a
a
a
a
a
a
a
a
a
b
c
c
c
b
a
a
a
a
a
a
a
a
a
a
a
a
a
a
a
a
a
a
a
a
a
a
a
a
a
a
a
a
a
a
a
"}
(34,1,1) = {"
a
a
a
a
a
a
b
h
h
h
h
h
h
h
h
h
h
h
h
h
h
h
b
c
c
c
c
c
c
c
c
c
c
c
c
c
c
c
c
c
c
c
c
c
c
c
c
b
c
c
c
c
c
b
a
a
a
a
a
a
a
a
a
a
b
c
c
c
b
a
a
a
a
a
a
a
a
a
a
a
a
a
a
a
a
a
a
a
a
a
a
a
a
a
a
a
a
a
a
a
"}
(35,1,1) = {"
a
a
a
a
a
a
b
h
h
h
h
h
h
h
h
h
h
h
h
h
h
h
b
c
c
c
c
c
c
c
c
c
c
c
c
c
c
c
c
c
c
c
c
c
c
c
c
b
c
c
c
c
c
b
a
a
a
a
a
a
b
b
b
b
b
c
c
c
b
a
a
a
a
a
a
a
a
a
a
a
a
a
a
a
a
a
a
a
a
a
a
a
a
a
a
a
a
a
a
a
"}
(36,1,1) = {"
a
a
a
a
a
a
b
h
h
h
h
h
h
h
h
h
h
h
h
h
h
h
b
c
c
c
c
c
c
c
c
c
c
c
c
c
c
c
c
c
c
c
c
c
c
c
c
b
c
c
c
c
c
b
a
a
a
a
a
a
b
c
c
c
c
c
c
c
b
a
a
a
a
a
a
a
a
a
a
a
a
a
a
a
a
a
a
a
a
a
a
a
a
a
a
a
a
a
a
a
"}
(37,1,1) = {"
a
a
a
a
a
a
b
h
h
h
h
h
h
h
h
h
h
h
h
h
h
h
b
c
c
c
c
c
c
c
c
c
c
c
c
c
c
c
c
c
c
c
c
c
c
c
c
b
b
b
b
b
b
b
a
a
a
a
a
a
b
c
c
c
c
c
c
c
b
a
a
a
a
a
a
a
a
a
a
a
a
a
a
a
a
a
a
a
a
a
a
a
a
a
a
a
a
a
a
a
"}
(38,1,1) = {"
a
a
a
a
a
a
b
b
b
b
b
b
b
h
h
h
b
b
b
b
b
b
b
b
b
b
b
b
b
b
b
b
b
b
b
e
e
e
c
c
c
c
c
c
c
c
c
c
c
c
c
b
a
a
a
a
a
a
a
a
b
c
c
c
c
c
c
c
b
a
a
a
a
a
a
a
a
a
a
a
a
a
a
a
a
a
a
a
a
a
a
a
a
a
a
a
a
a
a
a
"}
(39,1,1) = {"
a
a
a
a
a
a
a
a
a
a
a
a
b
b
h
b
b
c
c
c
c
c
c
c
b
c
c
c
b
c
c
c
c
c
c
c
c
e
c
c
c
c
c
c
c
c
c
c
c
c
c
b
a
a
a
a
a
a
a
a
b
c
c
c
b
b
b
b
b
b
b
b
b
b
a
a
a
a
a
a
a
a
a
a
a
a
a
a
a
a
a
a
a
a
a
a
a
a
a
a
"}
(40,1,1) = {"
a
a
a
a
a
a
a
a
a
a
a
a
b
c
c
c
b
c
c
c
c
c
c
c
c
c
c
c
c
c
c
c
c
c
c
c
c
e
c
c
c
c
c
c
c
c
c
c
c
c
c
b
a
a
a
a
a
a
a
a
b
c
c
c
b
c
c
c
c
c
c
c
c
b
a
a
a
a
a
a
a
a
a
a
a
a
a
a
a
a
a
a
a
a
a
a
a
a
a
a
"}
(41,1,1) = {"
a
a
a
a
a
a
a
a
a
a
a
a
b
c
c
c
b
c
c
c
c
c
c
c
b
c
c
c
b
c
c
c
c
c
c
c
c
e
c
c
c
c
c
c
c
c
c
c
c
c
c
b
a
a
a
a
a
a
a
a
b
c
c
c
b
c
c
c
c
c
c
c
c
b
a
a
b
b
b
b
b
b
b
a
a
a
a
a
a
a
a
a
a
a
a
a
a
a
a
a
"}
(42,1,1) = {"
a
a
a
a
a
a
a
a
a
a
a
a
b
c
c
c
b
b
b
c
c
b
b
b
b
b
b
b
b
b
c
b
b
c
c
c
c
e
d
c
c
c
c
c
c
c
c
c
c
c
c
b
a
a
a
a
a
a
a
a
b
c
c
c
b
c
c
c
c
c
c
c
c
b
a
a
b
c
b
c
b
c
b
a
a
a
a
a
a
a
a
a
a
a
a
a
a
a
a
a
"}
(43,1,1) = {"
a
a
a
a
a
a
a
a
a
a
a
a
b
c
c
c
b
c
c
c
c
c
c
c
c
c
c
c
b
c
c
c
b
c
c
c
c
e
c
c
c
c
c
c
c
c
c
c
c
c
c
b
a
a
a
a
a
a
a
a
b
c
c
c
c
c
c
c
c
c
c
c
c
b
a
a
b
c
b
c
b
c
b
a
a
a
a
a
a
a
a
a
a
a
a
a
a
a
a
a
"}
(44,1,1) = {"
a
a
a
a
a
a
a
a
a
a
a
a
b
c
c
c
b
c
c
c
c
c
c
c
c
c
c
c
b
c
c
c
b
c
c
c
c
e
c
c
c
c
c
c
c
c
c
c
c
c
c
b
a
a
a
a
a
a
a
a
b
c
c
c
c
c
c
c
c
c
c
c
c
b
b
b
b
c
c
c
c
c
b
a
a
a
a
a
a
a
a
a
a
a
a
a
a
a
a
a
"}
(45,1,1) = {"
a
a
a
a
a
a
a
a
a
a
a
a
b
c
c
c
b
c
c
c
c
c
c
c
c
c
c
c
b
b
c
b
b
c
c
c
c
e
c
c
c
c
c
c
c
c
c
c
c
c
c
b
a
a
a
a
a
a
a
a
b
c
c
c
b
c
c
c
c
c
c
c
c
b
c
c
c
c
c
c
c
c
b
a
a
a
a
a
a
a
a
a
a
a
a
a
a
a
a
a
"}
(46,1,1) = {"
a
a
a
a
a
a
a
a
a
a
a
a
b
c
c
c
b
c
c
b
c
c
b
c
c
b
c
c
b
c
c
c
b
c
c
c
c
e
c
c
c
c
c
c
c
c
c
c
c
c
c
b
a
a
a
a
a
a
a
a
b
c
c
c
b
c
c
c
c
c
c
c
c
c
c
c
c
c
c
c
c
c
b
a
a
a
a
a
a
a
a
a
a
a
a
a
a
a
a
a
"}
(47,1,1) = {"
a
a
a
a
a
a
a
a
a
a
a
a
b
c
c
c
b
c
c
b
b
b
b
b
b
b
c
c
b
c
c
c
b
c
c
c
c
e
d
c
c
c
c
c
c
c
c
c
c
c
c
b
a
a
a
a
a
a
a
a
b
c
c
c
b
c
c
c
c
c
c
c
c
b
c
c
c
c
c
c
c
c
b
a
a
a
a
a
a
a
a
a
a
a
a
a
a
a
a
a
"}
(48,1,1) = {"
a
a
a
a
a
a
a
a
a
a
a
a
b
c
c
c
b
c
c
b
c
c
b
c
c
b
c
c
b
c
c
c
b
c
c
c
c
e
c
c
c
c
c
b
c
c
c
c
b
b
b
b
b
b
b
b
b
b
b
b
b
c
c
c
b
c
f
f
f
c
c
c
c
b
b
b
b
b
b
b
b
b
b
a
a
a
a
a
b
b
b
b
b
b
b
b
a
a
a
a
"}
(49,1,1) = {"
a
a
a
a
a
a
a
a
a
a
a
a
b
c
c
c
b
c
c
c
c
c
c
c
c
c
c
c
b
b
c
b
b
c
c
c
c
e
c
c
c
c
c
b
c
c
c
c
b
a
a
b
c
c
c
c
c
c
c
c
c
c
c
c
b
c
c
c
f
c
c
c
c
b
a
a
a
a
a
a
a
a
a
a
a
a
a
a
b
c
c
c
c
c
c
b
a
a
a
a
"}
(50,1,1) = {"
a
a
a
a
a
a
a
a
a
a
a
a
b
c
c
c
b
c
c
c
c
c
c
c
c
c
c
c
b
c
c
c
b
c
c
c
c
e
c
c
c
c
c
b
c
c
c
c
b
b
b
b
c
c
c
c
c
c
c
c
c
c
c
c
b
c
c
c
f
c
c
c
c
b
b
b
b
b
b
b
b
b
b
b
b
b
b
b
b
c
g
g
g
g
c
b
a
a
a
a
"}
(51,1,1) = {"
a
a
a
a
a
a
a
a
a
a
a
a
b
b
c
b
b
c
c
c
c
c
c
c
c
c
c
c
b
c
c
c
b
c
c
c
c
e
c
c
c
c
c
b
c
c
c
c
c
c
c
c
c
c
c
c
c
c
c
c
c
c
c
c
b
c
c
c
f
c
c
c
c
c
c
c
c
c
c
c
c
c
c
c
c
c
c
c
c
c
g
g
g
g
c
b
a
a
a
a
"}
(52,1,1) = {"
a
a
a
a
a
a
a
a
b
b
b
b
b
c
c
c
b
b
b
b
b
b
b
b
b
b
b
b
b
b
c
b
b
b
b
e
e
e
c
c
c
c
c
b
c
c
c
c
c
c
c
c
c
c
c
c
c
c
c
c
c
c
c
c
c
c
c
c
f
c
c
c
c
c
c
c
c
c
c
c
c
c
c
c
c
c
c
c
c
c
g
g
g
g
c
b
a
a
a
a
"}
(53,1,1) = {"
a
a
a
a
a
a
a
a
b
f
f
f
c
c
c
c
c
c
c
c
e
c
c
b
c
c
c
c
c
c
c
c
c
c
c
c
c
c
c
c
c
c
c
b
c
c
c
c
c
c
c
c
c
c
c
c
c
c
c
c
c
c
c
c
c
c
c
c
f
c
c
c
c
c
c
c
c
c
c
c
c
c
c
c
c
c
c
c
c
c
g
g
g
g
c
b
a
a
a
a
"}
(54,1,1) = {"
a
a
a
a
a
a
a
a
b
f
c
c
c
c
c
c
c
c
c
c
e
c
c
b
c
c
c
c
c
c
c
c
c
c
c
c
c
c
c
c
c
c
c
b
c
c
c
c
b
b
b
b
c
c
c
c
c
c
c
c
c
c
c
c
b
c
c
c
f
c
c
c
c
b
b
b
b
b
b
b
b
b
b
b
b
b
b
b
b
c
g
g
g
g
c
b
a
a
a
a
"}
(55,1,1) = {"
a
a
a
a
a
a
a
a
b
c
c
c
c
c
c
c
c
c
c
c
c
c
c
b
c
c
c
c
c
c
c
c
c
c
c
c
c
c
c
c
c
c
c
b
c
c
c
c
b
a
a
b
c
c
c
c
c
c
c
c
c
c
c
c
b
c
c
c
f
c
c
c
c
b
a
a
a
a
a
a
a
a
a
a
a
a
a
a
b
c
c
c
c
c
c
b
a
a
a
a
"}
(56,1,1) = {"
a
a
a
a
a
a
a
a
b
c
c
c
c
c
c
f
f
f
c
c
b
b
b
b
c
c
c
c
c
c
c
c
c
c
c
c
c
c
c
c
c
c
c
b
c
c
c
c
b
b
b
b
b
b
b
b
b
b
b
b
b
c
c
c
b
c
c
c
f
c
c
c
c
b
b
b
b
b
b
b
b
b
b
a
a
a
a
a
b
b
b
b
b
b
b
b
a
a
a
a
"}
(57,1,1) = {"
a
a
a
a
a
a
a
a
b
c
f
f
c
c
c
c
c
f
c
c
e
c
c
b
c
c
c
c
c
c
c
c
c
c
c
c
c
c
c
c
c
c
c
c
c
c
c
c
c
c
c
b
a
a
a
a
a
a
a
a
b
c
c
c
b
f
f
f
f
c
c
c
c
b
c
c
c
c
c
c
c
c
b
a
a
a
a
a
a
a
a
a
a
a
a
a
a
a
a
a
"}
(58,1,1) = {"
a
a
a
a
a
a
a
a
b
c
f
f
c
c
c
c
c
f
c
c
e
c
c
b
c
c
c
c
c
c
c
c
c
c
c
c
c
c
c
c
c
c
c
c
c
c
c
c
c
c
c
b
a
a
a
a
a
a
a
a
b
c
c
c
b
c
c
c
c
c
c
c
c
c
c
c
c
c
c
c
c
c
b
a
a
a
a
a
a
a
a
a
a
a
a
a
a
a
a
a
"}
(59,1,1) = {"
a
a
a
a
a
a
a
a
b
c
f
f
c
c
c
c
c
f
c
c
c
c
c
b
c
c
c
c
c
c
c
c
c
c
c
c
c
c
c
c
c
c
c
c
c
c
c
c
c
c
c
b
a
a
a
a
a
a
a
a
b
c
c
c
b
c
c
c
c
c
c
c
c
b
c
c
c
c
c
c
c
c
b
a
a
a
a
a
a
a
a
a
a
a
a
a
a
a
a
a
"}
(60,1,1) = {"
a
a
a
a
a
a
a
a
b
c
c
c
c
c
c
f
f
f
c
c
b
b
b
b
c
c
c
c
c
c
c
c
c
c
c
c
c
c
c
c
c
c
c
c
c
c
c
c
c
c
c
b
a
a
a
a
a
a
a
a
b
c
c
c
b
c
c
c
c
c
c
c
c
b
b
b
b
c
c
c
c
c
b
a
a
a
a
a
a
a
a
a
a
a
a
a
a
a
a
a
"}
(61,1,1) = {"
a
a
a
a
a
a
a
a
b
c
c
c
c
c
c
c
c
c
c
c
e
c
c
b
c
c
c
c
c
c
c
c
c
c
c
c
c
c
c
c
c
c
c
c
c
c
c
c
c
c
c
b
a
a
a
a
a
a
a
a
b
c
c
c
c
c
c
c
c
c
c
c
c
b
a
a
b
c
b
c
b
c
b
a
a
a
a
a
a
a
a
a
a
a
a
a
a
a
a
a
"}
(62,1,1) = {"
a
a
a
a
a
a
a
a
b
c
c
c
c
c
c
c
c
c
c
c
e
c
c
b
c
c
c
c
c
c
c
c
c
c
c
c
c
c
c
c
c
c
c
c
c
c
c
c
c
c
c
b
a
a
a
a
a
a
a
a
b
c
c
c
c
c
c
c
c
c
c
c
c
b
a
a
b
c
b
c
b
c
b
a
a
a
a
a
a
a
a
a
a
a
a
a
a
a
a
a
"}
(63,1,1) = {"
a
a
a
a
a
a
a
a
b
c
c
c
c
c
c
c
c
c
c
c
c
c
c
b
c
c
c
c
c
c
c
c
c
c
c
c
c
c
c
c
c
c
c
c
c
c
c
c
c
c
c
b
a
a
a
a
a
a
a
a
b
c
c
c
b
c
c
c
c
c
c
c
c
b
a
a
b
b
b
b
b
b
b
a
a
a
a
a
a
a
a
a
a
a
a
a
a
a
a
a
"}
(64,1,1) = {"
a
a
a
a
a
a
a
a
b
c
c
b
b
b
b
b
b
b
b
b
b
b
b
b
c
c
c
c
c
c
c
c
c
c
c
c
c
c
c
c
c
c
c
c
c
c
c
c
c
c
c
b
a
a
a
a
a
a
a
a
b
c
c
c
b
c
c
c
c
c
c
c
c
b
a
a
a
a
a
a
a
a
a
a
a
a
a
a
a
a
a
a
a
a
a
a
a
a
a
a
"}
(65,1,1) = {"
a
a
a
a
a
a
a
a
b
c
c
b
c
c
c
f
c
c
c
c
c
c
j
b
b
b
b
b
b
b
b
b
b
b
b
b
b
b
b
b
b
b
b
b
b
b
b
b
b
b
b
b
b
b
a
a
a
a
a
a
b
c
c
c
b
c
c
c
c
c
c
c
c
b
a
a
a
a
a
a
a
a
a
a
a
a
a
a
a
a
a
a
a
a
a
a
a
a
a
a
"}
(66,1,1) = {"
a
a
a
a
a
a
a
a
b
c
c
b
c
c
c
f
c
c
c
c
c
c
j
b
a
a
a
a
b
f
f
f
c
c
c
b
c
c
c
c
b
c
c
c
c
c
c
c
c
c
c
c
c
b
a
a
a
a
a
a
b
c
c
c
b
b
b
b
b
b
b
b
b
b
a
a
a
a
a
a
a
a
a
a
a
a
a
a
a
a
a
a
a
a
a
a
a
a
a
a
"}
(67,1,1) = {"
a
a
a
a
a
a
a
a
b
c
c
b
c
c
c
b
c
c
c
c
c
c
c
b
a
a
a
a
b
f
c
c
c
c
c
e
c
c
c
c
b
c
c
c
c
c
c
c
c
c
c
c
c
b
a
a
a
a
a
a
b
c
c
c
c
c
c
c
c
c
c
c
c
b
a
a
a
a
a
a
a
a
a
a
a
a
a
a
a
a
a
a
a
a
a
a
a
a
a
a
"}
(68,1,1) = {"
a
a
a
a
a
a
a
a
b
c
c
b
c
c
c
f
c
c
c
c
c
c
j
b
a
a
a
a
b
f
c
c
c
c
f
e
c
c
c
c
b
c
c
c
c
f
f
f
f
f
c
c
c
b
a
a
a
a
a
a
b
c
c
c
c
c
c
c
c
c
c
c
c
b
a
a
a
a
a
a
a
a
a
a
a
a
a
a
a
a
a
a
a
a
a
a
a
a
a
a
"}
(69,1,1) = {"
a
a
a
a
a
a
a
a
b
c
c
b
c
c
c
f
c
c
c
c
c
c
j
b
a
a
a
a
b
c
c
c
c
c
f
e
c
c
c
c
b
c
c
c
c
f
k
k
k
f
c
c
c
b
a
a
a
a
a
a
b
c
c
c
c
c
c
c
c
c
c
c
c
b
b
b
b
b
b
b
b
b
b
b
b
b
b
b
b
b
b
b
b
b
b
b
b
b
b
b
"}
(70,1,1) = {"
a
a
a
a
a
a
a
a
b
c
c
c
c
c
c
b
c
c
c
c
c
c
c
b
a
a
a
a
b
c
c
c
c
c
m
e
c
c
c
c
b
c
c
c
c
m
k
c
k
f
c
c
c
b
a
a
a
a
a
a
b
b
b
b
b
c
c
c
b
c
c
c
c
b
c
c
c
c
c
c
c
c
c
c
c
c
c
c
c
b
c
c
c
c
c
c
c
c
c
b
"}
(71,1,1) = {"
a
a
a
a
a
a
a
a
b
c
c
b
c
c
c
f
c
c
c
c
c
c
j
b
a
a
a
a
b
c
c
c
c
c
f
e
c
c
c
c
b
c
c
c
c
f
k
c
k
p
c
c
c
b
a
a
a
a
a
a
a
a
a
a
b
c
c
c
b
c
c
c
c
b
c
c
c
c
c
c
c
c
c
c
c
c
c
c
c
b
c
c
c
c
c
c
c
c
c
b
"}
(72,1,1) = {"
a
a
a
a
a
a
a
a
b
c
c
b
c
c
c
f
c
c
c
c
c
c
j
b
a
a
a
a
b
c
c
c
c
c
f
e
c
c
c
c
b
c
c
c
c
f
f
c
f
m
c
c
c
b
a
a
a
a
a
a
a
a
a
a
b
c
c
c
b
c
c
c
c
b
c
c
c
c
c
c
c
c
c
c
c
c
c
c
c
b
c
c
c
c
c
c
c
c
c
b
"}
(73,1,1) = {"
a
a
a
a
a
a
a
a
b
c
c
b
c
c
c
b
c
c
c
c
c
c
c
b
a
a
a
a
b
c
c
c
c
c
c
e
c
c
c
c
b
c
c
c
c
c
c
c
c
c
c
c
c
b
a
a
a
a
a
a
a
a
a
a
b
c
c
c
b
c
c
c
c
b
c
c
c
c
c
c
c
c
c
c
c
c
c
c
c
b
c
c
c
c
c
c
c
c
c
b
"}
(74,1,1) = {"
a
a
a
a
a
a
a
a
b
c
c
b
c
c
c
f
c
c
c
c
c
c
j
b
a
a
a
a
b
c
c
c
c
b
b
b
c
c
c
c
b
c
c
c
c
c
c
c
c
c
c
c
c
b
a
a
a
a
a
a
a
a
a
a
b
c
c
c
b
c
c
c
c
b
c
c
c
c
c
c
c
c
c
c
c
c
c
c
c
b
c
c
c
c
c
c
c
c
c
b
"}
(75,1,1) = {"
a
a
a
a
a
a
a
a
b
c
c
b
c
c
c
f
c
c
c
c
c
c
j
b
a
a
a
a
b
c
c
c
c
c
c
c
c
c
c
c
b
c
c
c
c
c
c
c
c
c
c
c
c
b
a
a
a
a
a
a
a
a
a
a
b
c
c
c
b
c
c
c
c
b
c
c
c
c
c
c
c
c
c
c
c
c
c
c
c
b
c
c
c
c
c
c
c
c
c
b
"}
(76,1,1) = {"
a
a
a
a
a
a
a
a
b
c
c
b
b
b
b
b
b
b
b
b
b
b
b
b
a
a
a
a
b
c
c
c
c
b
b
b
c
c
c
c
b
c
c
c
c
c
c
c
c
c
c
c
c
b
a
a
a
a
a
a
a
a
a
a
b
c
c
c
b
c
c
c
c
b
c
c
c
c
c
c
c
c
c
c
c
c
c
c
c
b
c
c
c
c
c
c
c
c
c
b
"}
(77,1,1) = {"
a
a
a
a
a
a
a
a
b
c
c
c
c
c
c
c
c
c
c
c
c
c
c
b
b
b
b
b
b
b
b
c
b
b
b
b
b
b
b
b
b
b
b
b
b
b
b
c
b
b
b
b
b
b
a
a
a
a
a
a
a
a
a
a
b
c
c
c
b
c
c
c
c
b
b
b
c
c
c
b
b
b
b
b
b
b
b
b
b
b
c
c
c
c
c
c
c
c
c
b
"}
(78,1,1) = {"
a
a
a
a
a
a
a
a
b
c
c
c
c
c
c
c
c
c
c
c
c
c
c
b
f
f
k
f
b
a
b
c
b
a
a
a
a
a
a
a
a
a
a
a
a
a
b
c
b
b
b
b
b
b
a
a
a
a
a
a
a
a
a
a
b
c
c
c
b
c
c
c
c
b
a
b
c
c
c
b
a
a
a
a
a
a
a
a
a
b
c
c
c
c
c
c
c
c
c
b
"}
(79,1,1) = {"
a
a
a
a
a
a
a
a
b
b
b
b
c
b
b
b
b
b
b
b
b
b
b
b
f
c
c
c
b
b
b
c
b
b
b
b
b
b
b
b
b
b
b
b
b
b
b
c
b
b
b
b
b
b
b
b
b
b
b
b
b
b
b
b
b
c
c
c
b
c
c
c
c
b
b
b
c
c
c
b
b
b
b
b
b
b
b
b
b
b
b
b
c
b
b
b
b
b
b
b
"}
(80,1,1) = {"
a
a
a
a
a
a
a
a
b
f
c
c
c
c
c
c
c
c
b
c
c
c
c
b
k
c
c
c
b
c
c
c
c
c
c
c
c
c
c
c
c
c
c
c
c
c
c
c
c
c
c
c
c
c
c
c
c
c
c
c
c
c
c
c
c
c
c
c
b
c
c
c
c
b
c
c
c
c
c
c
c
c
c
c
c
c
c
b
c
c
c
b
c
b
c
c
c
c
c
b
"}
(81,1,1) = {"
a
a
a
a
a
a
a
a
b
f
c
c
c
c
c
c
c
c
c
c
c
c
c
b
f
c
c
c
c
c
c
c
c
c
c
c
c
c
c
c
c
c
c
c
c
c
c
c
c
c
c
c
c
c
c
c
c
c
c
c
c
c
c
c
c
c
c
c
b
c
c
c
c
c
c
c
c
c
c
c
c
c
c
c
c
c
c
c
c
c
c
c
c
c
c
c
c
c
c
b
"}
(82,1,1) = {"
a
a
a
a
a
a
a
a
b
f
c
c
c
c
c
c
c
c
b
c
c
c
c
b
k
c
c
c
b
c
c
c
c
c
c
c
c
c
c
c
c
c
c
c
c
c
c
c
c
c
c
c
c
c
c
c
c
c
c
c
c
c
c
c
c
c
c
c
b
c
c
c
c
b
c
c
c
c
c
c
c
c
c
c
c
c
c
b
c
c
c
b
c
b
c
c
c
c
c
b
"}
(83,1,1) = {"
a
a
a
a
a
a
a
a
b
f
c
c
c
f
f
c
c
c
b
c
c
c
c
b
f
c
c
c
b
b
b
b
b
b
c
b
b
b
b
b
b
b
b
b
b
b
b
c
b
b
b
b
b
b
b
b
b
b
b
b
b
b
b
b
b
b
b
b
b
b
b
b
b
b
b
b
b
b
b
b
b
b
b
b
b
b
b
b
b
b
b
b
c
b
b
b
b
b
b
b
"}
(84,1,1) = {"
a
a
a
a
a
a
a
a
b
b
b
c
b
b
b
b
c
b
b
b
b
b
b
b
f
f
k
f
b
a
a
a
a
b
c
b
a
a
a
a
a
a
a
a
a
a
b
c
b
a
a
a
a
a
b
a
a
a
a
a
a
a
a
a
a
a
a
a
a
a
a
a
a
a
a
a
a
a
a
a
a
a
a
a
a
a
a
a
a
b
c
c
c
c
c
c
c
c
c
b
"}
(85,1,1) = {"
a
a
a
a
a
a
a
a
b
c
c
c
c
b
c
c
c
c
c
b
a
a
a
b
b
b
b
b
b
b
b
b
b
b
c
b
b
b
b
b
b
b
b
b
b
b
b
c
b
b
b
b
b
b
b
a
a
a
a
a
a
a
a
a
a
a
a
a
a
a
a
a
a
a
a
a
a
a
a
a
a
a
a
a
a
a
a
a
a
b
c
c
c
c
c
c
c
c
c
b
"}
(86,1,1) = {"
a
a
a
a
a
a
a
a
b
c
c
c
c
b
c
c
c
c
c
b
a
a
a
a
a
a
a
a
b
c
c
c
c
c
c
c
e
c
c
c
e
c
c
c
c
c
c
c
b
c
c
c
c
c
b
a
a
a
a
a
a
a
a
a
a
a
a
a
a
a
a
a
a
a
a
a
a
a
a
a
a
a
a
a
a
a
a
a
a
b
c
c
c
c
c
c
c
c
c
b
"}
(87,1,1) = {"
a
a
a
a
a
a
a
a
b
c
c
c
c
b
c
c
c
c
c
b
a
a
a
a
a
a
a
a
b
c
c
c
c
c
c
c
c
c
c
c
e
c
c
c
c
c
c
c
c
c
c
c
c
c
b
a
a
a
a
a
a
a
a
a
a
a
a
a
a
a
a
a
a
a
a
a
a
a
a
a
a
a
a
a
a
a
a
a
a
b
c
c
c
c
c
c
c
c
c
b
"}
(88,1,1) = {"
a
a
a
a
a
a
a
a
b
b
b
b
b
b
b
b
b
b
b
b
a
a
a
a
a
a
a
a
b
c
c
c
c
c
c
c
e
c
c
c
e
c
c
c
c
c
c
c
b
c
b
c
b
c
b
a
a
a
a
a
a
a
a
a
a
a
a
a
a
a
a
a
a
a
a
a
a
a
a
a
a
a
a
a
a
a
a
a
a
b
c
c
c
c
c
c
c
c
c
b
"}
(89,1,1) = {"
a
a
a
a
a
a
a
a
a
a
a
a
a
a
a
a
a
a
a
a
a
a
a
a
a
a
a
a
b
c
c
c
c
c
c
c
b
b
b
b
b
c
c
f
f
c
c
c
b
c
b
c
b
c
b
a
a
a
a
a
a
a
a
a
a
a
a
a
a
a
a
a
a
a
a
a
a
a
a
a
a
a
a
a
a
a
a
a
a
b
c
c
c
c
c
c
c
c
c
b
"}
(90,1,1) = {"
a
a
a
a
a
a
a
a
a
a
a
a
a
a
a
a
a
a
a
a
a
a
a
a
a
a
a
a
b
c
c
c
c
c
c
c
e
c
c
c
e
c
c
f
f
c
c
c
b
b
b
b
b
b
b
a
a
a
a
a
a
a
a
a
a
a
a
a
a
a
a
a
a
a
a
a
a
a
a
a
a
a
a
a
a
a
a
a
a
b
c
c
c
c
c
c
c
c
c
b
"}
(91,1,1) = {"
a
a
a
a
a
a
a
a
a
a
a
a
a
a
a
a
a
a
a
a
a
a
a
a
a
a
a
a
b
c
c
c
c
c
c
c
c
c
c
w
o
w
c
f
f
c
c
c
b
c
b
c
b
c
b
a
a
a
a
a
a
a
a
a
a
a
a
a
a
a
a
a
a
a
a
a
a
a
a
a
a
a
a
a
a
a
a
a
a
b
c
c
c
c
c
c
c
c
c
b
"}
(92,1,1) = {"
a
a
a
a
a
a
a
a
a
a
a
a
a
a
a
a
a
a
a
a
a
a
a
a
a
a
a
a
b
c
c
c
c
c
c
c
e
c
c
w
o
w
c
f
f
c
c
c
b
c
b
c
b
c
b
a
a
a
a
a
a
a
a
a
a
a
a
a
a
a
a
a
a
a
a
a
a
a
a
a
a
a
a
a
a
a
a
a
a
b
c
c
c
c
c
c
c
c
c
b
"}
(93,1,1) = {"
a
a
a
a
a
a
a
a
a
a
a
a
a
a
a
a
a
a
a
a
a
a
a
a
a
a
a
a
b
c
c
c
c
c
c
c
b
b
b
b
b
c
c
f
f
c
c
c
c
c
c
c
c
c
b
a
a
a
a
a
a
a
a
a
a
a
a
a
a
a
a
a
a
a
a
a
a
a
a
a
a
a
a
a
a
a
a
a
a
b
b
b
b
b
b
b
b
b
b
b
"}
(94,1,1) = {"
a
a
a
a
a
a
a
a
a
a
a
a
a
a
a
a
a
a
a
a
a
a
a
a
a
a
a
a
b
c
c
c
c
c
c
c
e
c
c
c
e
c
c
c
c
c
c
c
b
c
c
c
c
c
b
a
a
a
a
a
a
a
a
a
a
a
a
a
a
a
a
a
a
a
a
a
a
a
a
a
a
a
a
a
a
a
a
a
a
a
a
a
a
a
a
a
a
a
a
a
"}
(95,1,1) = {"
a
a
a
a
a
a
a
a
a
a
a
a
a
a
a
a
a
a
a
a
a
a
a
a
a
a
a
a
b
c
c
c
c
c
c
c
c
c
c
c
e
c
c
c
c
c
c
c
b
b
b
b
b
b
b
a
a
a
a
a
a
a
a
a
a
a
a
a
a
a
a
a
a
a
a
a
a
a
a
a
a
a
a
a
a
a
a
a
a
a
a
a
a
a
a
a
a
a
a
a
"}
(96,1,1) = {"
a
a
a
a
a
a
a
a
a
a
a
a
a
a
a
a
a
a
a
a
a
a
a
a
a
a
a
a
b
c
c
c
c
c
c
c
e
c
c
c
e
c
c
c
c
c
c
c
b
a
a
a
a
a
b
a
a
a
a
a
a
a
a
a
a
a
a
a
a
a
a
a
a
a
a
a
a
a
a
a
a
a
a
a
a
a
a
a
a
a
a
a
a
a
a
a
a
a
a
a
"}
(97,1,1) = {"
a
a
a
a
a
a
a
a
a
a
a
a
a
a
a
a
a
a
a
a
a
a
a
a
a
a
a
a
b
b
b
b
b
b
b
b
b
b
b
b
b
b
b
b
b
b
b
b
b
b
b
b
b
b
b
a
a
a
a
a
a
a
a
a
a
a
a
a
a
a
a
a
a
a
a
a
a
a
a
a
a
a
a
a
a
a
a
a
a
a
a
a
a
a
a
a
a
a
a
a
"}
(98,1,1) = {"
a
a
a
a
a
a
a
a
a
a
a
a
a
a
a
a
a
a
a
a
a
a
a
a
a
a
a
a
a
a
a
a
a
a
a
a
a
a
a
a
a
a
a
a
a
a
a
a
a
a
a
a
a
a
a
a
a
a
a
a
a
a
a
a
a
a
a
a
a
a
a
a
a
a
a
a
a
a
a
a
a
a
a
a
a
a
a
a
a
a
a
a
a
a
a
a
a
a
a
a
"}
(99,1,1) = {"
a
a
a
a
a
a
a
a
a
a
a
a
a
a
a
a
a
a
a
a
a
a
a
a
a
a
a
a
a
a
a
a
a
a
a
a
a
a
a
a
a
a
a
a
a
a
a
a
a
a
a
a
a
a
a
a
a
a
a
a
a
a
a
a
a
a
a
a
a
a
a
a
a
a
a
a
a
a
a
a
a
a
a
a
a
a
a
a
a
a
a
a
a
a
a
a
a
a
a
a
"}
(100,1,1) = {"
a
a
a
a
a
a
a
a
a
a
a
a
a
a
a
a
a
a
a
a
a
a
a
a
a
a
a
a
a
a
a
a
a
a
a
a
a
a
a
a
a
a
a
a
a
a
a
a
a
a
a
a
a
a
a
a
a
a
a
a
a
a
a
a
a
a
a
a
a
a
a
a
a
a
a
a
a
a
a
a
a
a
a
a
a
a
a
a
a
a
a
a
a
a
a
a
a
a
a
a
"}
