//MAP CONVERTED BY dmm2tgm.py THIS HEADER COMMENT PREVENTS RECONVERSION, DO NOT REMOVE
"a" = (
/turf/closed/wall/f13/tentwall,
/area/f13/wasteland)
"b" = (
/obj/structure/rack/shelf_wood,
/obj/structure/rug/big/rug_red{
	layer = 0
	},
/turf/open/floor/f13/wood{
	icon_state = "oakfloor1"
	},
/area/f13/wasteland)
"c" = (
/obj/structure/bed/wooden,
/obj/item/bedsheet/black,
/obj/structure/rug/big/rug_red{
	layer = 0
	},
/turf/open/floor/f13/wood{
	icon_state = "oakfloor1"
	},
/area/f13/wasteland)
"d" = (
/obj/effect/turf_decal/siding/wood{
	dir = 10
	},
/turf/open/indestructible/ground/outside/gravel{
	color = "#777777"
	},
/area/f13/wasteland)
"e" = (
/obj/structure/rack/shelf_wood,
/turf/open/floor/f13/wood{
	icon_state = "oakfloor1"
	},
/area/f13/wasteland)
"f" = (
/obj/structure/railing/wood{
	pixel_y = 0;
	dir = 1
	},
/obj/structure/railing/wood/post{
	dir = 2
	},
/turf/open/indestructible/ground/outside/gravel,
/area/f13/wasteland)
"g" = (
/turf/open/indestructible/ground/outside/gravel,
/area/f13/wasteland)
"i" = (
/turf/open/floor/f13/wood{
	icon_state = "oakfloor1"
	},
/area/f13/wasteland)
"j" = (
/obj/effect/turf_decal/siding/wood{
	dir = 4
	},
/turf/open/indestructible/ground/outside/gravel{
	color = "#777777"
	},
/area/f13/wasteland)
"k" = (
/obj/structure/table/wood,
/turf/open/floor/f13/wood{
	icon_state = "oakfloor1"
	},
/area/f13/wasteland)
"l" = (
/obj/effect/turf_decal/siding/wood{
	dir = 8
	},
/turf/open/indestructible/ground/outside/gravel{
	color = "#777777"
	},
/area/f13/wasteland)
"m" = (
/obj/structure/closet/crate/wicker,
/turf/open/floor/f13/wood{
	icon_state = "oakfloor1"
	},
/area/f13/wasteland)
"n" = (
/obj/effect/turf_decal/siding/wood/corner{
	dir = 4
	},
/turf/open/indestructible/ground/outside/gravel{
	color = "#777777"
	},
/area/f13/wasteland)
"o" = (
/obj/structure/railing/wood{
	pixel_y = 0;
	dir = 1
	},
/obj/structure/railing/wood/post{
	dir = 4
	},
/obj/structure/railing/wood/post{
	dir = 2
	},
/obj/structure/destructible/tribal_torch{
	layer = 5
	},
/turf/open/indestructible/ground/outside/gravel,
/area/f13/wasteland)
"p" = (
/obj/structure/bed/wooden,
/obj/item/bedsheet/black,
/turf/open/floor/f13/wood{
	icon_state = "oakfloor1"
	},
/area/f13/wasteland)
"q" = (
/obj/structure/railing/wood{
	dir = 8;
	pixel_x = -1
	},
/obj/structure/railing/wood/post{
	dir = 8;
	pixel_y = 5
	},
/turf/open/indestructible/ground/outside/gravel,
/area/f13/wasteland)
"r" = (
/obj/structure/railing/wood{
	pixel_y = 0;
	dir = 1
	},
/obj/structure/railing/wood/post{
	dir = 8
	},
/obj/structure/railing/wood/post{
	dir = 2
	},
/obj/structure/destructible/tribal_torch{
	layer = 5;
	pixel_x = 1
	},
/turf/open/indestructible/ground/outside/gravel,
/area/f13/wasteland)
"s" = (
/obj/structure/railing/wood{
	dir = 4;
	pixel_y = 0;
	pixel_x = 1
	},
/obj/structure/railing/wood/post{
	dir = 4
	},
/turf/open/indestructible/ground/outside/gravel,
/area/f13/wasteland)
"t" = (
/obj/structure/railing/wood{
	dir = 8;
	pixel_x = -1
	},
/turf/open/indestructible/ground/outside/gravel,
/area/f13/wasteland)
"u" = (
/obj/structure/table/wood,
/obj/structure/destructible/tribal_torch/wall{
	dir = 4
	},
/turf/open/floor/f13/wood{
	icon_state = "oakfloor1"
	},
/area/f13/wasteland)
"v" = (
/turf/closed/wall/f13/tentwall{
	icon_state = "tent9"
	},
/area/f13/wasteland)
"w" = (
/obj/effect/turf_decal/siding/wood/corner{
	dir = 1
	},
/turf/open/indestructible/ground/outside/gravel{
	color = "#777777"
	},
/area/f13/wasteland)
"x" = (
/obj/effect/turf_decal/siding/wood{
	dir = 1
	},
/turf/open/indestructible/ground/outside/gravel{
	color = "#777777"
	},
/area/f13/wasteland)
"y" = (
/obj/structure/simple_door/tent,
/turf/open/floor/f13/wood{
	icon_state = "oakfloor1"
	},
/area/f13/wasteland)
"z" = (
/obj/structure/table/wood,
/obj/structure/destructible/tribal_torch/wall{
	dir = 8
	},
/turf/open/floor/f13/wood{
	icon_state = "oakfloor1"
	},
/area/f13/wasteland)
"A" = (
/obj/effect/turf_decal/siding/wood,
/obj/structure/chair/bench{
	pixel_y = 10
	},
/turf/open/indestructible/ground/outside/gravel{
	color = "#777777"
	},
/area/f13/wasteland)
"B" = (
/obj/effect/turf_decal/siding/wood/corner,
/turf/open/indestructible/ground/outside/gravel{
	color = "#777777"
	},
/area/f13/wasteland)
"C" = (
/obj/structure/railing/wood{
	pixel_y = 0;
	dir = 1
	},
/obj/structure/railing/wood{
	dir = 4;
	pixel_y = 0;
	pixel_x = 1
	},
/obj/structure/railing/wood/post{
	dir = 4
	},
/obj/structure/railing/wood/post{
	dir = 2
	},
/obj/structure/destructible/tribal_torch{
	layer = 5
	},
/turf/open/indestructible/ground/outside/gravel,
/area/f13/wasteland)
"D" = (
/obj/structure/railing/wood{
	dir = 4;
	pixel_y = 0;
	pixel_x = 1
	},
/turf/open/indestructible/ground/outside/gravel,
/area/f13/wasteland)
"E" = (
/obj/structure/closet/crate/wicker,
/obj/structure/rug/big/rug_red{
	layer = 0
	},
/turf/open/floor/f13/wood{
	icon_state = "oakfloor1"
	},
/area/f13/wasteland)
"F" = (
/obj/structure/rug/big/rug_red{
	layer = 0
	},
/turf/open/floor/f13/wood{
	icon_state = "oakfloor1"
	},
/area/f13/wasteland)
"G" = (
/obj/effect/turf_decal/siding/wood{
	dir = 6
	},
/turf/open/indestructible/ground/outside/gravel{
	color = "#777777"
	},
/area/f13/wasteland)
"H" = (
/obj/structure/bonfire{
	pixel_y = 4
	},
/turf/open/indestructible/ground/inside/mountain,
/area/f13/wasteland)
"I" = (
/obj/structure/railing/wood{
	pixel_y = 0;
	dir = 1
	},
/obj/structure/railing/wood{
	dir = 8;
	pixel_x = -1
	},
/obj/structure/railing/wood/post{
	dir = 8
	},
/obj/structure/railing/wood/post{
	dir = 2
	},
/obj/structure/destructible/tribal_torch{
	layer = 5;
	pixel_x = 1
	},
/turf/open/indestructible/ground/outside/gravel,
/area/f13/wasteland)
"J" = (
/obj/effect/turf_decal/siding/wood/corner{
	dir = 8
	},
/turf/open/indestructible/ground/outside/gravel{
	color = "#777777"
	},
/area/f13/wasteland)
"K" = (
/obj/structure/table/wood,
/obj/structure/destructible/tribal_torch/wall{
	dir = 1;
	pixel_y = 16
	},
/turf/open/floor/f13/wood{
	icon_state = "oakfloor1"
	},
/area/f13/wasteland)
"L" = (
/obj/structure/railing/wood{
	pixel_y = 0
	},
/obj/structure/railing/wood/post{
	dir = 4;
	pixel_y = 5
	},
/obj/structure/railing/wood/post{
	dir = 1
	},
/turf/open/indestructible/ground/outside/gravel,
/area/f13/wasteland)
"M" = (
/obj/structure/railing/wood{
	pixel_y = 0
	},
/obj/structure/railing/wood/post{
	dir = 1
	},
/turf/open/indestructible/ground/outside/gravel,
/area/f13/wasteland)
"N" = (
/obj/effect/turf_decal/siding/wood{
	dir = 5
	},
/turf/open/indestructible/ground/outside/gravel{
	color = "#777777"
	},
/area/f13/wasteland)
"O" = (
/turf/closed/wall/f13/tentwall{
	icon_state = "tent5"
	},
/area/f13/wasteland)
"P" = (
/obj/effect/turf_decal/siding/wood{
	dir = 1
	},
/obj/structure/chair/bench,
/turf/open/indestructible/ground/outside/gravel{
	color = "#777777"
	},
/area/f13/wasteland)
"Q" = (
/turf/closed/wall/f13/tentwall{
	icon_state = "tent6"
	},
/area/f13/wasteland)
"R" = (
/obj/structure/railing/wood{
	pixel_y = 0
	},
/obj/structure/railing/wood{
	dir = 8;
	pixel_x = -1
	},
/obj/structure/railing/wood/post{
	dir = 8;
	pixel_y = 5
	},
/obj/structure/railing/wood/post{
	dir = 1
	},
/turf/open/indestructible/ground/outside/gravel,
/area/f13/wasteland)
"S" = (
/obj/structure/railing/wood{
	pixel_y = 0
	},
/obj/structure/railing/wood/post{
	dir = 8;
	pixel_y = 5
	},
/obj/structure/railing/wood/post{
	dir = 1
	},
/turf/open/indestructible/ground/outside/gravel,
/area/f13/wasteland)
"T" = (
/obj/structure/railing/wood{
	pixel_y = 0
	},
/obj/structure/railing/wood{
	dir = 4;
	pixel_y = 0;
	pixel_x = 1
	},
/obj/structure/railing/wood/post{
	dir = 4;
	pixel_y = 5
	},
/obj/structure/railing/wood/post{
	dir = 1
	},
/turf/open/indestructible/ground/outside/gravel,
/area/f13/wasteland)
"U" = (
/turf/closed/wall/f13/tentwall{
	icon_state = "tent10"
	},
/area/f13/wasteland)
"V" = (
/obj/effect/turf_decal/siding/wood,
/turf/open/indestructible/ground/outside/gravel{
	color = "#777777"
	},
/area/f13/wasteland)
"W" = (
/obj/effect/turf_decal/siding/wood{
	dir = 9
	},
/turf/open/indestructible/ground/outside/gravel{
	color = "#777777"
	},
/area/f13/wasteland)
"X" = (
/obj/structure/railing/wood{
	dir = 4;
	pixel_x = 1
	},
/obj/structure/railing/wood/post{
	dir = 4;
	pixel_y = 5
	},
/turf/open/indestructible/ground/outside/gravel,
/area/f13/wasteland)
"Y" = (
/obj/structure/destructible/tribal_torch/wall,
/turf/open/floor/f13/wood{
	icon_state = "oakfloor1"
	},
/area/f13/wasteland)
"Z" = (
/obj/structure/railing/wood{
	dir = 8;
	pixel_x = -1
	},
/obj/structure/railing/wood/post{
	dir = 8
	},
/turf/open/indestructible/ground/outside/gravel,
/area/f13/wasteland)

(1,1,1) = {"
R
t
Z
Q
a
a
a
a
a
O
q
I
"}
(2,1,1) = {"
M
g
g
a
e
c
z
p
b
a
g
f
"}
(3,1,1) = {"
L
g
Q
a
m
i
k
i
m
a
O
f
"}
(4,1,1) = {"
Q
a
a
i
i
i
i
i
i
i
a
o
"}
(5,1,1) = {"
a
e
E
i
W
l
l
l
d
Y
a
O
"}
(6,1,1) = {"
a
p
i
i
P
B
j
n
A
i
i
y
"}
(7,1,1) = {"
a
K
k
i
P
V
H
x
A
i
i
y
"}
(8,1,1) = {"
a
p
F
i
P
J
l
w
A
i
i
y
"}
(9,1,1) = {"
a
e
m
i
N
j
j
j
G
Y
a
v
"}
(10,1,1) = {"
U
a
a
i
i
i
i
i
i
i
a
r
"}
(11,1,1) = {"
S
g
U
a
m
F
k
i
E
a
v
f
"}
(12,1,1) = {"
M
g
g
a
e
p
u
p
e
a
g
f
"}
(13,1,1) = {"
T
D
s
U
a
a
a
a
a
v
X
C
"}
