//MAP CONVERTED BY dmm2tgm.py THIS HEADER COMMENT PREVENTS RECONVERSION, DO NOT REMOVE
"a" = (
/turf/open/floor/f13/wood{
	icon_state = "oakfloor1"
	},
/area/f13/wasteland)
"b" = (
/turf/closed/wall/f13/tentwall{
	icon_state = "tent6"
	},
/area/f13/wasteland)
"e" = (
/obj/structure/destructible/tribal_torch/wall{
	dir = 4
	},
/turf/open/floor/f13/wood{
	icon_state = "oakfloor1"
	},
/area/f13/wasteland)
"g" = (
/obj/structure/table/wood/settler,
/obj/structure/destructible/tribal_torch/wall{
	dir = 1;
	pixel_y = 16
	},
/turf/open/floor/f13/wood{
	icon_state = "oakfloor1"
	},
/area/f13/wasteland)
"k" = (
/obj/structure/furnace,
/turf/open/floor/f13/wood{
	icon_state = "oakfloor1"
	},
/area/f13/wasteland)
"l" = (
/obj/structure/closet/crate/wooden{
	pixel_y = 10
	},
/turf/open/floor/f13/wood{
	icon_state = "oakfloor1"
	},
/area/f13/wasteland)
"m" = (
/obj/structure/rug/big/rug_red{
	layer = 0
	},
/turf/open/floor/f13/wood{
	icon_state = "oakfloor1"
	},
/area/f13/wasteland)
"n" = (
/obj/structure/table/wood/settler,
/turf/open/floor/f13/wood{
	icon_state = "oakfloor1"
	},
/area/f13/wasteland)
"r" = (
/turf/closed/wall/f13/tentwall{
	icon_state = "tent10"
	},
/area/f13/wasteland)
"s" = (
/turf/closed/wall/f13/tentwall{
	icon_state = "tent9"
	},
/area/f13/wasteland)
"w" = (
/obj/structure/destructible/tribal_torch/wall,
/turf/open/floor/f13/wood{
	icon_state = "oakfloor1"
	},
/area/f13/wasteland)
"x" = (
/obj/structure/table/wood/settler,
/obj/structure/sink/greyscale{
	color = "#715030";
	desc = "A wooden basin used for washing one's hands and face.";
	name = "Water Basin";
	pixel_x = 12;
	dir = 4;
	pixel_y = 4
	},
/turf/open/floor/f13/wood{
	icon_state = "oakfloor1"
	},
/area/f13/wasteland)
"y" = (
/obj/machinery/chem_master/primitive,
/turf/open/floor/f13/wood{
	icon_state = "oakfloor1"
	},
/area/f13/wasteland)
"F" = (
/obj/machinery/workbench,
/turf/open/floor/f13/wood{
	icon_state = "oakfloor1"
	},
/area/f13/wasteland)
"G" = (
/obj/structure/reagent_dispensers/barrel/explosive,
/turf/open/floor/f13/wood{
	icon_state = "oakfloor1"
	},
/area/f13/wasteland)
"H" = (
/turf/closed/wall/f13/tentwall{
	icon_state = "tent5"
	},
/area/f13/wasteland)
"I" = (
/obj/structure/anvil/obtainable/basic,
/turf/open/floor/f13/wood{
	icon_state = "oakfloor1"
	},
/area/f13/wasteland)
"J" = (
/obj/structure/simple_door/tent,
/turf/open/floor/f13/wood{
	icon_state = "oakfloor1"
	},
/area/f13/wasteland)
"K" = (
/obj/structure/rack/shelf_wood,
/turf/open/floor/f13/wood{
	icon_state = "oakfloor1"
	},
/area/f13/wasteland)
"M" = (
/obj/machinery/smartfridge/drying_rack,
/turf/open/floor/f13/wood{
	icon_state = "oakfloor1"
	},
/area/f13/wasteland)
"N" = (
/obj/machinery/workbench/forge,
/turf/open/floor/f13/wood{
	icon_state = "oakfloor1"
	},
/area/f13/wasteland)
"O" = (
/turf/closed/wall/f13/tentwall,
/area/f13/wasteland)
"V" = (
/obj/structure/table/wood/settler,
/turf/open/floor/f13/wood{
	icon_state = "oakfloor1"
	},
/area/f13/wasteland)

(1,1,1) = {"
b
O
O
O
O
O
H
"}
(2,1,1) = {"
O
n
n
l
K
K
O
"}
(3,1,1) = {"
O
y
a
a
a
m
J
"}
(4,1,1) = {"
O
g
a
a
a
a
J
"}
(5,1,1) = {"
O
l
a
a
a
w
O
"}
(6,1,1) = {"
O
F
a
M
a
K
O
"}
(7,1,1) = {"
O
K
a
V
a
I
O
"}
(8,1,1) = {"
O
N
a
V
a
k
O
"}
(9,1,1) = {"
O
a
e
x
e
G
O
"}
(10,1,1) = {"
r
O
O
O
O
O
s
"}
