//MAP CONVERTED BY dmm2tgm.py THIS HEADER COMMENT PREVENTS RECONVERSION, DO NOT REMOVE
"cA" = (
/mob/living/simple_animal/hostile/supermutant/nightkin/elitemutant,
/turf/open/indestructible/ground/inside/subway,
/area/f13/tunnel)
"cQ" = (
/obj/structure/closet/radiation,
/turf/open/floor/plasteel/f13/vault_floor/yellow,
/area/f13/tunnel)
"jG" = (
/mob/living/simple_animal/hostile/radscorpion/black,
/turf/open/indestructible/ground/inside/mountain,
/area/f13/tunnel)
"kE" = (
/turf/open/indestructible/ground/inside/subway,
/area/f13/tunnel)
"lz" = (
/mob/living/simple_animal/hostile/stalker,
/turf/open/floor/plasteel/f13/vault_floor/yellow,
/area/f13/tunnel)
"lE" = (
/obj/structure/simple_door/bunker,
/turf/open/floor/plasteel/f13/vault_floor/yellow,
/area/f13/tunnel)
"mZ" = (
/obj/structure/barricade/sandbags,
/turf/open/indestructible/ground/inside/subway,
/area/f13/tunnel)
"qz" = (
/turf/open/indestructible/ground/inside/mountain,
/area/f13/tunnel)
"qQ" = (
/mob/living/simple_animal/hostile/supermutant/rangedmutant,
/turf/open/indestructible/ground/inside/subway,
/area/f13/tunnel)
"wI" = (
/turf/closed/mineral/random/low_chance,
/area/f13/tunnel)
"Bu" = (
/obj/machinery/light/small,
/obj/structure/table/wood/settler,
/obj/machinery/cell_charger,
/turf/open/floor/plasteel/f13/vault_floor/yellow,
/area/f13/tunnel)
"BH" = (
/turf/closed/mineral/random/low_chance,
/area/f13/caves)
"Er" = (
/obj/machinery/workbench/advanced,
/obj/item/book/granter/crafting_recipe/gunsmith_three,
/obj/item/book/granter/crafting_recipe/gunsmith_two,
/turf/open/floor/plasteel/f13/vault_floor/yellow,
/area/f13/tunnel)
"Ga" = (
/obj/machinery/space_heater,
/turf/open/floor/plasteel/f13/vault_floor/yellow,
/area/f13/tunnel)
"GY" = (
/mob/living/simple_animal/hostile/stalkeryoung,
/turf/open/floor/plasteel/f13/vault_floor/yellow,
/area/f13/tunnel)
"JS" = (
/turf/open/floor/plasteel/f13/vault_floor/yellow,
/area/f13/tunnel)
"Kb" = (
/obj/item/storage/trash_stack,
/turf/open/indestructible/ground/inside/subway,
/area/f13/tunnel)
"Ns" = (
/turf/closed/wall/f13/ruins,
/area/f13/tunnel)
"NS" = (
/obj/structure/timeddoor,
/turf/open/indestructible/ground/inside/subway,
/area/f13/tunnel)
"OT" = (
/obj/effect/spawner/lootdrop/f13/weapon/gun/tier4,
/turf/open/indestructible/ground/inside/subway,
/area/f13/tunnel)
"PS" = (
/obj/structure/timeddoor,
/turf/closed/wall/r_wall/f13/vault,
/area/f13/tunnel)
"QU" = (
/turf/closed/indestructible/rock,
/area/f13/caves)
"SR" = (
/obj/machinery/light/small{
	brightness = 3;
	dir = 8
	},
/turf/open/indestructible/ground/inside/subway,
/area/f13/tunnel)
"SW" = (
/obj/effect/spawner/lootdrop/f13/armor/tier4,
/turf/open/indestructible/ground/inside/subway,
/area/f13/tunnel)
"Tq" = (
/mob/living/simple_animal/hostile/supermutant,
/turf/open/indestructible/ground/inside/subway,
/area/f13/tunnel)
"UX" = (
/obj/structure/table/wood/settler,
/obj/machinery/recharger,
/turf/open/floor/plasteel/f13/vault_floor/yellow,
/area/f13/tunnel)
"Yn" = (
/mob/living/simple_animal/hostile/supermutant/nightkin/rangedmutant,
/turf/open/indestructible/ground/inside/subway,
/area/f13/tunnel)
"YH" = (
/obj/machinery/light/small{
	dir = 1
	},
/obj/machinery/space_heater,
/turf/open/floor/plasteel/f13/vault_floor/yellow,
/area/f13/tunnel)
"ZN" = (
/obj/effect/spawner/lootdrop/f13/blueprintMid,
/turf/open/indestructible/ground/inside/subway,
/area/f13/tunnel)

(1,1,1) = {"
QU
QU
QU
QU
QU
QU
QU
BH
BH
BH
BH
BH
BH
BH
BH
BH
BH
BH
BH
BH
BH
QU
QU
BH
qz
qz
BH
qz
BH
QU
BH
BH
BH
BH
BH
BH
"}
(2,1,1) = {"
QU
kE
kE
kE
kE
BH
QU
BH
BH
BH
BH
BH
BH
BH
BH
BH
BH
BH
BH
BH
BH
BH
QU
BH
BH
qz
BH
qz
BH
QU
BH
BH
BH
BH
BH
BH
"}
(3,1,1) = {"
QU
kE
kE
kE
kE
BH
QU
BH
BH
BH
BH
BH
BH
BH
BH
BH
BH
BH
BH
BH
BH
BH
QU
QU
BH
qz
qz
BH
BH
QU
BH
BH
BH
BH
QU
QU
"}
(4,1,1) = {"
QU
kE
kE
kE
kE
BH
QU
BH
BH
BH
BH
BH
BH
BH
BH
BH
BH
BH
BH
BH
BH
BH
BH
QU
BH
BH
qz
BH
BH
QU
BH
BH
BH
BH
QU
BH
"}
(5,1,1) = {"
QU
kE
kE
kE
kE
BH
QU
BH
BH
BH
BH
BH
BH
BH
BH
BH
BH
BH
BH
BH
BH
BH
BH
QU
QU
BH
qz
qz
BH
QU
QU
QU
QU
QU
QU
BH
"}
(6,1,1) = {"
QU
kE
kE
ZN
kE
BH
QU
BH
BH
BH
BH
BH
BH
BH
BH
BH
BH
BH
BH
BH
BH
BH
BH
BH
QU
BH
BH
qz
BH
BH
BH
BH
BH
BH
BH
BH
"}
(7,1,1) = {"
QU
kE
kE
kE
kE
BH
QU
BH
BH
QU
QU
QU
QU
QU
QU
QU
QU
QU
BH
BH
BH
BH
BH
BH
QU
QU
BH
qz
qz
BH
BH
qz
qz
qz
BH
qz
"}
(8,1,1) = {"
QU
kE
kE
kE
kE
BH
QU
BH
BH
QU
BH
BH
BH
BH
BH
BH
BH
QU
BH
BH
BH
BH
BH
BH
BH
QU
BH
BH
qz
qz
BH
jG
qz
qz
qz
qz
"}
(9,1,1) = {"
QU
kE
kE
kE
kE
BH
QU
QU
QU
QU
BH
kE
kE
kE
kE
BH
BH
QU
BH
BH
BH
BH
BH
BH
BH
QU
QU
BH
BH
qz
qz
qz
qz
BH
BH
BH
"}
(10,1,1) = {"
QU
kE
kE
kE
kE
BH
BH
BH
BH
BH
BH
kE
kE
kE
OT
BH
BH
QU
BH
BH
BH
BH
BH
BH
BH
BH
QU
QU
BH
BH
BH
BH
BH
BH
QU
QU
"}
(11,1,1) = {"
QU
kE
kE
kE
qQ
mZ
kE
kE
kE
kE
mZ
qQ
kE
kE
kE
BH
BH
QU
BH
BH
BH
BH
BH
BH
BH
BH
BH
QU
QU
QU
QU
QU
QU
QU
QU
BH
"}
(12,1,1) = {"
QU
BH
BH
BH
BH
BH
BH
BH
mZ
BH
BH
kE
kE
kE
kE
BH
BH
QU
BH
BH
BH
BH
BH
BH
BH
BH
BH
BH
BH
BH
BH
BH
BH
BH
BH
BH
"}
(13,1,1) = {"
QU
BH
BH
BH
BH
BH
BH
BH
kE
BH
BH
kE
kE
kE
kE
BH
BH
QU
BH
BH
BH
BH
BH
BH
BH
BH
BH
BH
BH
BH
BH
BH
BH
BH
BH
BH
"}
(14,1,1) = {"
QU
BH
BH
BH
BH
BH
BH
BH
kE
BH
BH
BH
BH
BH
BH
BH
BH
QU
BH
BH
BH
BH
BH
BH
BH
BH
BH
BH
BH
BH
BH
BH
BH
BH
BH
BH
"}
(15,1,1) = {"
QU
QU
QU
QU
QU
QU
QU
BH
kE
BH
QU
QU
QU
QU
QU
QU
QU
QU
BH
BH
BH
BH
BH
BH
BH
BH
BH
BH
BH
BH
BH
BH
BH
BH
BH
BH
"}
(16,1,1) = {"
QU
BH
BH
BH
BH
BH
BH
BH
kE
BH
BH
BH
BH
BH
BH
BH
BH
QU
BH
BH
BH
BH
BH
BH
BH
BH
BH
BH
BH
BH
BH
BH
BH
BH
BH
BH
"}
(17,1,1) = {"
QU
BH
BH
BH
BH
BH
BH
BH
kE
kE
BH
BH
BH
BH
BH
BH
BH
QU
BH
BH
BH
BH
BH
BH
BH
BH
BH
BH
BH
BH
BH
BH
BH
BH
BH
BH
"}
(18,1,1) = {"
QU
BH
BH
BH
BH
BH
BH
BH
kE
kE
BH
BH
BH
BH
BH
BH
BH
QU
BH
BH
BH
BH
BH
BH
BH
BH
BH
BH
BH
BH
BH
BH
BH
BH
BH
BH
"}
(19,1,1) = {"
QU
BH
BH
BH
BH
BH
BH
BH
kE
kE
BH
BH
BH
BH
BH
BH
BH
QU
BH
BH
BH
BH
BH
BH
BH
BH
BH
BH
BH
BH
BH
BH
BH
BH
BH
BH
"}
(20,1,1) = {"
QU
BH
BH
BH
BH
BH
BH
BH
kE
kE
BH
BH
BH
BH
BH
BH
BH
QU
BH
BH
BH
BH
BH
BH
BH
BH
BH
BH
BH
BH
BH
BH
BH
BH
BH
BH
"}
(21,1,1) = {"
QU
BH
BH
BH
BH
BH
BH
BH
kE
kE
BH
BH
BH
BH
BH
BH
BH
QU
BH
BH
BH
BH
BH
BH
BH
BH
BH
BH
BH
BH
BH
BH
BH
BH
BH
BH
"}
(22,1,1) = {"
QU
BH
BH
BH
BH
BH
BH
BH
kE
kE
BH
BH
BH
BH
BH
BH
BH
QU
BH
BH
BH
BH
BH
BH
BH
BH
BH
BH
BH
BH
BH
BH
BH
BH
BH
BH
"}
(23,1,1) = {"
QU
BH
BH
BH
BH
BH
BH
BH
qQ
qQ
BH
BH
BH
BH
BH
BH
BH
QU
BH
BH
BH
BH
BH
BH
BH
BH
BH
BH
BH
BH
BH
BH
BH
BH
BH
BH
"}
(24,1,1) = {"
QU
BH
BH
BH
BH
BH
BH
BH
mZ
mZ
BH
BH
BH
BH
BH
PS
PS
wI
wI
wI
wI
wI
wI
wI
wI
wI
wI
wI
Ns
Ns
Ns
Ns
Ns
Ns
Ns
Ns
"}
(25,1,1) = {"
QU
BH
kE
kE
kE
kE
kE
kE
kE
kE
kE
Tq
kE
kE
kE
mZ
NS
kE
kE
kE
SR
kE
kE
kE
kE
kE
kE
kE
Kb
kE
kE
kE
kE
kE
kE
SR
"}
(26,1,1) = {"
QU
BH
kE
kE
kE
kE
kE
kE
kE
kE
Tq
kE
kE
kE
kE
kE
NS
kE
kE
kE
kE
kE
kE
Kb
kE
kE
kE
kE
kE
kE
kE
kE
kE
kE
kE
kE
"}
(27,1,1) = {"
QU
BH
kE
kE
kE
kE
kE
kE
kE
kE
kE
kE
Tq
kE
kE
mZ
NS
kE
kE
kE
kE
kE
kE
kE
kE
kE
kE
kE
kE
kE
kE
kE
kE
kE
kE
Kb
"}
(28,1,1) = {"
QU
BH
BH
BH
BH
BH
BH
BH
mZ
mZ
kE
BH
BH
BH
BH
PS
PS
wI
wI
wI
wI
wI
wI
wI
wI
wI
wI
wI
Ns
Ns
Ns
lE
Ns
Ns
Ns
Ns
"}
(29,1,1) = {"
QU
BH
BH
BH
BH
BH
BH
BH
qQ
qQ
BH
BH
BH
BH
BH
BH
BH
QU
BH
BH
BH
BH
BH
BH
BH
BH
BH
BH
Ns
Ga
JS
JS
JS
UX
Ns
BH
"}
(30,1,1) = {"
QU
BH
BH
BH
BH
BH
BH
BH
kE
kE
BH
BH
BH
BH
BH
BH
BH
QU
BH
BH
BH
BH
BH
BH
BH
BH
BH
BH
Ns
YH
lz
GY
lz
Bu
Ns
BH
"}
(31,1,1) = {"
QU
BH
BH
BH
BH
BH
BH
BH
kE
kE
BH
BH
BH
BH
BH
BH
BH
QU
BH
BH
BH
BH
BH
BH
BH
BH
BH
BH
Ns
cQ
JS
JS
JS
Er
Ns
BH
"}
(32,1,1) = {"
QU
BH
BH
BH
BH
BH
BH
BH
kE
kE
BH
BH
BH
BH
BH
BH
BH
QU
BH
BH
BH
BH
BH
BH
BH
BH
BH
BH
Ns
Ns
Ns
Ns
Ns
Ns
Ns
BH
"}
(33,1,1) = {"
QU
BH
BH
BH
BH
BH
BH
BH
kE
BH
BH
BH
BH
BH
BH
BH
BH
QU
QU
QU
QU
QU
QU
QU
QU
QU
QU
QU
QU
QU
QU
QU
QU
QU
BH
BH
"}
(34,1,1) = {"
QU
BH
BH
BH
BH
BH
BH
BH
kE
BH
BH
BH
BH
BH
BH
BH
BH
BH
BH
BH
BH
BH
BH
BH
BH
BH
BH
BH
BH
BH
BH
BH
BH
QU
BH
BH
"}
(35,1,1) = {"
QU
BH
BH
BH
BH
BH
BH
BH
kE
BH
BH
BH
BH
BH
BH
BH
BH
BH
BH
BH
BH
BH
BH
BH
BH
BH
BH
BH
BH
BH
BH
BH
BH
QU
BH
BH
"}
(36,1,1) = {"
QU
BH
BH
BH
BH
BH
BH
BH
kE
kE
kE
kE
kE
kE
kE
kE
kE
kE
kE
kE
mZ
kE
BH
BH
BH
BH
BH
BH
BH
BH
BH
BH
BH
QU
BH
BH
"}
(37,1,1) = {"
QU
BH
BH
BH
BH
BH
BH
BH
kE
kE
kE
kE
kE
kE
kE
BH
BH
BH
BH
BH
kE
mZ
kE
kE
kE
kE
kE
kE
kE
kE
kE
BH
QU
QU
BH
BH
"}
(38,1,1) = {"
QU
BH
BH
BH
BH
BH
BH
BH
kE
BH
BH
BH
BH
BH
BH
BH
BH
BH
BH
BH
BH
BH
BH
BH
BH
kE
BH
BH
BH
BH
kE
BH
BH
QU
BH
BH
"}
(39,1,1) = {"
QU
BH
BH
BH
BH
BH
BH
BH
kE
BH
QU
QU
QU
QU
QU
QU
QU
QU
QU
QU
QU
QU
QU
BH
BH
kE
BH
QU
BH
kE
mZ
kE
kE
QU
BH
BH
"}
(40,1,1) = {"
QU
BH
BH
BH
BH
BH
BH
BH
kE
BH
BH
BH
BH
BH
BH
BH
BH
BH
BH
BH
BH
BH
QU
BH
BH
kE
BH
QU
BH
kE
kE
mZ
kE
QU
BH
BH
"}
(41,1,1) = {"
QU
BH
BH
BH
BH
BH
BH
BH
kE
BH
BH
BH
BH
kE
kE
kE
kE
mZ
Yn
SW
kE
BH
QU
BH
BH
kE
BH
QU
BH
kE
kE
kE
kE
QU
BH
BH
"}
(42,1,1) = {"
QU
BH
BH
BH
BH
BH
BH
BH
kE
kE
kE
kE
mZ
kE
kE
kE
kE
mZ
kE
kE
kE
BH
QU
BH
BH
kE
BH
QU
BH
kE
cA
kE
kE
QU
BH
BH
"}
(43,1,1) = {"
QU
BH
BH
BH
BH
BH
BH
BH
BH
BH
BH
BH
BH
kE
kE
kE
kE
kE
kE
kE
kE
BH
QU
BH
BH
kE
BH
QU
BH
kE
kE
kE
kE
QU
BH
BH
"}
(44,1,1) = {"
QU
BH
BH
BH
BH
BH
BH
BH
BH
BH
BH
BH
BH
kE
kE
kE
kE
kE
kE
mZ
Yn
BH
QU
BH
BH
kE
BH
QU
BH
BH
BH
BH
BH
QU
BH
BH
"}
(45,1,1) = {"
QU
BH
BH
BH
BH
BH
BH
BH
BH
BH
BH
BH
BH
kE
kE
kE
kE
kE
kE
kE
mZ
BH
QU
BH
BH
kE
BH
QU
QU
QU
QU
QU
QU
QU
BH
BH
"}
(46,1,1) = {"
QU
BH
BH
BH
BH
BH
BH
BH
BH
BH
BH
BH
BH
kE
kE
kE
kE
kE
kE
kE
kE
BH
QU
BH
BH
kE
BH
BH
BH
BH
BH
BH
BH
QU
BH
BH
"}
(47,1,1) = {"
QU
BH
BH
BH
BH
BH
BH
BH
BH
BH
BH
BH
BH
kE
kE
kE
kE
kE
kE
kE
kE
BH
QU
BH
BH
kE
BH
BH
BH
BH
BH
BH
BH
QU
BH
BH
"}
(48,1,1) = {"
QU
BH
BH
BH
BH
BH
BH
BH
BH
BH
BH
BH
BH
kE
kE
kE
kE
kE
kE
kE
kE
BH
QU
BH
BH
kE
BH
BH
BH
BH
BH
BH
BH
QU
BH
BH
"}
(49,1,1) = {"
QU
BH
BH
BH
BH
BH
BH
BH
BH
BH
BH
BH
BH
BH
BH
mZ
BH
BH
BH
BH
BH
BH
QU
BH
BH
kE
BH
BH
BH
BH
BH
BH
BH
QU
BH
BH
"}
(50,1,1) = {"
QU
BH
BH
BH
BH
BH
BH
BH
BH
BH
BH
BH
BH
BH
BH
kE
BH
QU
QU
QU
QU
QU
QU
BH
BH
kE
BH
BH
BH
BH
BH
BH
BH
QU
BH
BH
"}
(51,1,1) = {"
QU
BH
BH
BH
BH
BH
BH
BH
BH
BH
BH
BH
BH
BH
BH
kE
BH
BH
BH
BH
BH
BH
BH
BH
BH
kE
BH
BH
BH
BH
BH
BH
BH
QU
BH
BH
"}
(52,1,1) = {"
QU
BH
BH
BH
BH
BH
BH
BH
BH
BH
BH
BH
BH
BH
BH
kE
kE
kE
kE
kE
kE
kE
kE
kE
kE
kE
BH
BH
BH
BH
BH
BH
BH
QU
BH
BH
"}
(53,1,1) = {"
QU
BH
BH
BH
BH
BH
BH
BH
BH
BH
BH
BH
BH
BH
BH
BH
BH
BH
BH
BH
BH
BH
BH
BH
kE
kE
BH
BH
BH
BH
BH
BH
BH
QU
BH
BH
"}
(54,1,1) = {"
QU
BH
BH
BH
BH
BH
BH
BH
BH
BH
BH
BH
BH
BH
BH
BH
BH
BH
BH
BH
BH
BH
BH
BH
kE
kE
BH
BH
BH
BH
BH
BH
BH
QU
BH
BH
"}
(55,1,1) = {"
QU
BH
BH
BH
BH
BH
BH
BH
BH
BH
BH
BH
BH
BH
BH
BH
BH
BH
BH
BH
BH
BH
QU
BH
BH
kE
BH
QU
QU
QU
QU
BH
BH
QU
BH
BH
"}
(56,1,1) = {"
QU
BH
BH
BH
BH
BH
BH
BH
BH
BH
BH
BH
BH
BH
BH
BH
BH
BH
BH
BH
BH
BH
QU
BH
BH
mZ
BH
BH
BH
BH
QU
BH
BH
QU
BH
BH
"}
(57,1,1) = {"
QU
BH
BH
BH
BH
BH
BH
BH
BH
BH
BH
BH
BH
BH
BH
BH
BH
BH
BH
BH
BH
BH
QU
BH
kE
cA
kE
kE
kE
BH
QU
BH
BH
QU
BH
BH
"}
(58,1,1) = {"
QU
BH
BH
BH
BH
BH
BH
BH
BH
BH
BH
BH
BH
BH
BH
BH
BH
BH
BH
BH
BH
BH
QU
BH
kE
ZN
kE
kE
kE
BH
QU
BH
BH
QU
BH
BH
"}
(59,1,1) = {"
QU
BH
BH
BH
BH
BH
BH
BH
BH
BH
BH
BH
BH
BH
BH
BH
BH
BH
BH
BH
BH
BH
QU
BH
kE
kE
kE
kE
kE
BH
QU
BH
BH
QU
BH
BH
"}
(60,1,1) = {"
QU
QU
QU
QU
QU
QU
QU
QU
QU
QU
QU
QU
QU
QU
QU
QU
QU
QU
QU
QU
QU
QU
QU
QU
QU
QU
QU
QU
QU
QU
QU
QU
QU
QU
BH
BH
"}
