//MAP CONVERTED BY dmm2tgm.py THIS HEADER COMMENT PREVENTS RECONVERSION, DO NOT REMOVE
"aD" = (
/obj/effect/spawner/lootdrop/f13/medical/vault/meds,
/turf/open/floor/plating/tunnel,
/area/f13/tunnel)
"aS" = (
/obj/item/reagent_containers/food/snacks/f13/deathclawegg,
/turf/open/indestructible/ground/inside/mountain,
/area/f13/tunnel)
"bS" = (
/obj/machinery/light/small,
/obj/effect/spawner/lootdrop/f13/armor/tier4,
/turf/open/floor/plating/tunnel,
/area/f13/tunnel)
"cQ" = (
/obj/structure/closet/radiation,
/turf/open/floor/plasteel/f13/vault_floor/yellow,
/area/f13/tunnel)
"dx" = (
/obj/machinery/light/small{
	dir = 1
	},
/obj/effect/spawner/lootdrop/f13/medical/vault/meds,
/turf/open/floor/plasteel/grimy,
/area/f13/tunnel)
"dM" = (
/obj/machinery/light/small{
	dir = 8
	},
/turf/open/indestructible/ground/inside/mountain,
/area/f13/tunnel)
"dP" = (
/obj/effect/decal/cleanable/dirt,
/obj/effect/decal/cleanable/dirt,
/mob/living/simple_animal/hostile/deathclaw,
/turf/open/floor/plating/tunnel,
/area/f13/tunnel)
"es" = (
/obj/effect/decal/cleanable/blood/tracks{
	dir = 4
	},
/turf/open/indestructible/ground/inside/mountain,
/area/f13/tunnel)
"ew" = (
/obj/effect/decal/cleanable/blood/old{
	icon_state = "floor5-old"
	},
/turf/open/floor/f13{
	icon_state = "darkrusty"
	},
/area/f13/tunnel)
"eA" = (
/obj/effect/spawner/lootdrop/f13/weapon/gun/tier2,
/turf/open/floor/plating/tunnel,
/area/f13/tunnel)
"eW" = (
/obj/machinery/autolathe/constructionlathe,
/turf/open/floor/plasteel/f13/vault_floor/yellow,
/area/f13/tunnel)
"fj" = (
/obj/effect/decal/remains/human,
/obj/effect/decal/cleanable/blood/old{
	icon_state = "floor4-old"
	},
/turf/open/indestructible/ground/inside/mountain,
/area/f13/tunnel)
"fU" = (
/mob/living/simple_animal/hostile/deathclaw/mother,
/turf/open/indestructible/ground/inside/mountain,
/area/f13/tunnel)
"fZ" = (
/obj/machinery/autolathe/ammo,
/turf/open/floor/plasteel/f13/vault_floor/yellow,
/area/f13/tunnel)
"gb" = (
/obj/effect/decal/cleanable/blood/tracks{
	dir = 6
	},
/obj/effect/mine/stun,
/turf/open/indestructible/ground/inside/mountain,
/area/f13/tunnel)
"gC" = (
/obj/machinery/light/small{
	dir = 1
	},
/obj/machinery/portable_atmospherics/pump,
/turf/open/floor/plating/tunnel,
/area/f13/tunnel)
"gJ" = (
/obj/effect/decal/cleanable/blood/tracks{
	dir = 9
	},
/mob/living/simple_animal/hostile/deathclaw,
/turf/open/indestructible/ground/inside/mountain,
/area/f13/tunnel)
"gM" = (
/mob/living/simple_animal/hostile/supermutant/rangedmutant,
/turf/open/floor/plasteel/neutral,
/area/f13/tunnel)
"hA" = (
/obj/structure/simple_door/bunker,
/turf/open/floor/plating/tunnel,
/area/f13/tunnel)
"hF" = (
/obj/effect/decal/cleanable/dirt,
/turf/open/floor/f13{
	icon_state = "darkrusty"
	},
/area/f13/tunnel)
"hL" = (
/obj/machinery/portable_atmospherics/canister,
/turf/open/floor/plating/tunnel,
/area/f13/tunnel)
"iu" = (
/obj/effect/decal/waste,
/turf/open/floor/plating/tunnel,
/area/f13/tunnel)
"iC" = (
/obj/effect/decal/cleanable/blood/tracks{
	dir = 5
	},
/turf/open/indestructible/ground/inside/mountain,
/area/f13/tunnel)
"iY" = (
/turf/closed/wall/r_wall/f13/vault,
/area/f13/tunnel)
"jl" = (
/obj/structure/closet,
/obj/effect/spawner/lootdrop/f13/weapon/gun/ammo/tier5,
/obj/effect/spawner/lootdrop/f13/weapon/gun/ammo/tier5,
/obj/effect/decal/cleanable/dirt,
/obj/effect/spawner/lootdrop/f13/weapon/gun/ammo/tier5,
/turf/open/floor/f13{
	icon_state = "darkrusty"
	},
/area/f13/tunnel)
"jG" = (
/mob/living/simple_animal/hostile/radscorpion/black,
/turf/open/indestructible/ground/inside/mountain,
/area/f13/tunnel)
"kt" = (
/mob/living/simple_animal/hostile/supermutant,
/turf/open/floor/plasteel/neutral/side{
	dir = 8
	},
/area/f13/tunnel)
"kz" = (
/obj/machinery/light/small,
/obj/machinery/conveyor/auto{
	dir = 4
	},
/turf/open/floor/plating/tunnel,
/area/f13/tunnel)
"kE" = (
/turf/open/indestructible/ground/inside/subway,
/area/f13/tunnel)
"kG" = (
/obj/structure/rack,
/obj/item/stack/sheet/cardboard/fifty,
/obj/item/stack/sheet/cardboard/fifty,
/obj/item/stack/sheet/cardboard/fifty,
/obj/item/stack/sheet/cardboard/fifty,
/turf/open/floor/plating/tunnel,
/area/f13/tunnel)
"lw" = (
/obj/effect/decal/waste{
	icon_state = "goo10"
	},
/turf/open/floor/plating/tunnel,
/area/f13/tunnel)
"lz" = (
/mob/living/simple_animal/hostile/stalker,
/turf/open/floor/plasteel/f13/vault_floor/yellow,
/area/f13/tunnel)
"lE" = (
/obj/structure/simple_door/bunker,
/turf/open/floor/plasteel/f13/vault_floor/yellow,
/area/f13/tunnel)
"lM" = (
/obj/effect/decal/cleanable/blood/old{
	icon_state = "floor6-old"
	},
/obj/effect/decal/cleanable/dirt,
/mob/living/simple_animal/hostile/deathclaw/legendary{
	bare_wound_bonus = 10;
	health = 1250;
	melee_damage_lower = 85;
	melee_damage_upper = 90;
	name = "Alpha Deathclaw";
	speed = -1.25;
	wound_bonus = 10
	},
/turf/open/floor/plating/tunnel,
/area/f13/tunnel)
"lW" = (
/obj/machinery/light/small,
/turf/open/floor/plating/tunnel,
/area/f13/tunnel)
"mj" = (
/obj/machinery/door/window/southleft,
/turf/open/floor/plating/tunnel,
/area/f13/tunnel)
"mR" = (
/obj/effect/decal/cleanable/blood/old{
	icon_state = "gib4-old"
	},
/obj/effect/decal/cleanable/dirt,
/turf/open/floor/f13{
	icon_state = "darkrusty"
	},
/area/f13/tunnel)
"mT" = (
/mob/living/simple_animal/hostile/supermutant/legendary,
/turf/open/floor/plasteel/grimy,
/area/f13/tunnel)
"mU" = (
/obj/machinery/conveyor/auto{
	dir = 4
	},
/obj/structure/plasticflaps,
/turf/closed/wall/r_wall/f13/vault,
/area/f13/tunnel)
"mZ" = (
/obj/structure/barricade/sandbags,
/turf/open/indestructible/ground/inside/subway,
/area/f13/tunnel)
"nd" = (
/obj/structure/simple_door/bunker,
/turf/open/floor/plasteel/floorgrime,
/area/f13/tunnel)
"nz" = (
/obj/effect/decal/waste{
	icon_state = "goo5"
	},
/turf/open/floor/plating/tunnel,
/area/f13/tunnel)
"nD" = (
/obj/structure/rack,
/obj/effect/spawner/lootdrop/f13/weapon/gun/tier5,
/turf/open/floor/f13{
	icon_state = "darkrusty"
	},
/area/f13/tunnel)
"nU" = (
/mob/living/simple_animal/hostile/supermutant/rangedmutant,
/turf/open/floor/plasteel/neutral/side{
	dir = 4
	},
/area/f13/tunnel)
"pa" = (
/obj/effect/decal/cleanable/blood/old{
	icon_state = "floor7-old"
	},
/turf/open/floor/f13{
	icon_state = "darkrusty"
	},
/area/f13/tunnel)
"pb" = (
/obj/structure/closet/crate/trashcart,
/obj/effect/spawner/lootdrop/f13/weapon/gun/ammo/tier4,
/obj/effect/spawner/lootdrop/f13/weapon/gun/random,
/turf/open/floor/plating/tunnel,
/area/f13/tunnel)
"pi" = (
/mob/living/simple_animal/hostile/supermutant,
/turf/open/floor/plasteel/neutral/side,
/area/f13/tunnel)
"pG" = (
/obj/machinery/light/small{
	brightness = 3;
	dir = 8
	},
/mob/living/simple_animal/hostile/supermutant/rangedmutant,
/turf/open/floor/plasteel/neutral,
/area/f13/tunnel)
"pJ" = (
/turf/open/floor/plasteel/neutral/side{
	dir = 6
	},
/area/f13/tunnel)
"pK" = (
/obj/structure/closet/crate,
/obj/effect/decal/cleanable/dirt,
/obj/effect/spawner/lootdrop/f13/blueprintHigh,
/obj/item/clothing/suit/armor/f13/power_armor/t45d{
	color = "#C1C1C1";
	desc = "(IX) Originally developed and manufactured for the United States Army by American defense contractor West Tek, the T-45d power armor was the first version of power armor to be successfully deployed in battle. This set looks somewhat bashed up and worn";
	item_color = "#C1C1C1"
	},
/obj/item/clothing/head/helmet/f13/power_armor/t45d{
	color = "#C1C1C1";
	desc = "(IX) It's an old pre-War power armor helmet. It's pretty hot inside of it. Nice.";
	item_color = "#C1C1C1"
	},
/turf/open/floor/f13{
	icon_state = "darkrusty"
	},
/area/f13/tunnel)
"pS" = (
/mob/living/simple_animal/hostile/supermutant/rangedmutant,
/turf/open/floor/plasteel/neutral/side{
	dir = 8
	},
/area/f13/tunnel)
"pV" = (
/obj/effect/decal/cleanable/blood/tracks{
	dir = 10
	},
/turf/open/indestructible/ground/inside/mountain,
/area/f13/tunnel)
"qb" = (
/obj/structure/rack,
/obj/item/stack/sheet/glass/fifty,
/obj/item/stack/sheet/glass/fifty,
/obj/item/stack/sheet/glass/fifty,
/obj/item/stack/sheet/glass/fifty,
/obj/item/stack/sheet/glass/fifty,
/turf/open/floor/plating/tunnel,
/area/f13/tunnel)
"qv" = (
/obj/effect/decal/waste{
	icon_state = "goo8"
	},
/turf/open/floor/plating/tunnel,
/area/f13/tunnel)
"qz" = (
/turf/open/indestructible/ground/inside/mountain,
/area/f13/tunnel)
"qY" = (
/obj/effect/decal/waste{
	icon_state = "goo12"
	},
/turf/open/floor/plating/tunnel,
/area/f13/tunnel)
"rm" = (
/obj/machinery/light/small{
	dir = 4
	},
/turf/open/indestructible/ground/inside/mountain,
/area/f13/tunnel)
"rQ" = (
/obj/machinery/light/small{
	dir = 1
	},
/obj/structure/closet/crate/trashcart,
/obj/effect/spawner/lootdrop/f13/weapon/gun/tier2,
/turf/open/floor/plating/tunnel,
/area/f13/tunnel)
"rU" = (
/turf/open/floor/plasteel/grimy,
/area/f13/tunnel)
"sw" = (
/turf/open/floor/plasteel/neutral,
/area/f13/tunnel)
"sZ" = (
/obj/machinery/light/small,
/turf/open/indestructible/ground/inside/mountain,
/area/f13/tunnel)
"tO" = (
/obj/machinery/light/small,
/obj/effect/decal/cleanable/dirt,
/obj/effect/decal/cleanable/dirt,
/turf/open/floor/f13{
	icon_state = "darkrusty"
	},
/area/f13/tunnel)
"us" = (
/turf/open/floor/plasteel/neutral/corner{
	dir = 4
	},
/area/f13/tunnel)
"uT" = (
/mob/living/simple_animal/hostile/supermutant/rangedmutant,
/turf/open/floor/plasteel/grimy,
/area/f13/tunnel)
"va" = (
/obj/structure/window/spawner/east,
/turf/open/floor/plating/tunnel,
/area/f13/tunnel)
"vA" = (
/obj/effect/decal/cleanable/blood/old{
	icon_state = "floor4-old"
	},
/turf/open/floor/plating/tunnel,
/area/f13/tunnel)
"vD" = (
/obj/machinery/light/small{
	brightness = 3;
	dir = 8
	},
/turf/open/floor/plasteel/neutral/side{
	dir = 4
	},
/area/f13/tunnel)
"vE" = (
/obj/machinery/button/door{
	id = "pain";
	name = "Door Control"
	},
/turf/closed/wall/r_wall/f13/vault,
/area/f13/tunnel)
"wa" = (
/obj/effect/decal/cleanable/blood/old{
	icon_state = "floor7-old"
	},
/turf/open/indestructible/ground/inside/mountain,
/area/f13/tunnel)
"wj" = (
/obj/structure/barricade/sandbags,
/turf/open/floor/plasteel/neutral/side{
	dir = 8
	},
/area/f13/tunnel)
"wr" = (
/obj/machinery/recharge_station,
/turf/open/floor/plating/tunnel,
/area/f13/tunnel)
"wt" = (
/obj/machinery/light/small{
	dir = 1
	},
/obj/structure/closet/crate/trashcart,
/obj/effect/spawner/lootdrop/f13/weapon/gun/tier3,
/obj/effect/spawner/lootdrop/f13/blueprintMid,
/turf/open/floor/plating/tunnel,
/area/f13/tunnel)
"wI" = (
/turf/closed/mineral/random/low_chance,
/area/f13/tunnel)
"wM" = (
/obj/structure/closet/crate/trashcart,
/obj/effect/spawner/lootdrop/f13/weapon/gun/tier2,
/turf/open/floor/plating/tunnel,
/area/f13/tunnel)
"wO" = (
/obj/machinery/light/small{
	dir = 4
	},
/mob/living/simple_animal/hostile/supermutant,
/turf/open/floor/plasteel/neutral/side{
	dir = 8
	},
/area/f13/tunnel)
"yY" = (
/mob/living/simple_animal/hostile/deathclaw/mother,
/turf/open/water,
/area/f13/tunnel)
"za" = (
/turf/open/floor/plasteel/neutral/corner{
	dir = 1
	},
/area/f13/tunnel)
"zs" = (
/mob/living/simple_animal/hostile/deathclaw,
/turf/open/indestructible/ground/inside/mountain,
/area/f13/tunnel)
"zV" = (
/obj/effect/decal/waste{
	icon_state = "goo5"
	},
/mob/living/simple_animal/hostile/centaur,
/turf/open/floor/plating/tunnel,
/area/f13/tunnel)
"Aw" = (
/obj/effect/decal/cleanable/dirt,
/obj/effect/decal/cleanable/dirt,
/turf/open/floor/plating/tunnel,
/area/f13/tunnel)
"AR" = (
/obj/machinery/light/small{
	dir = 1
	},
/obj/machinery/portable_atmospherics/canister,
/turf/open/floor/plating/tunnel,
/area/f13/tunnel)
"AS" = (
/mob/living/simple_animal/hostile/supermutant,
/turf/open/floor/plasteel/grimy,
/area/f13/tunnel)
"Bu" = (
/obj/machinery/light/small,
/obj/structure/table/wood/settler,
/obj/machinery/cell_charger,
/turf/open/floor/plasteel/f13/vault_floor/yellow,
/area/f13/tunnel)
"BH" = (
/turf/closed/mineral/random/low_chance,
/area/f13/caves)
"BQ" = (
/obj/effect/decal/cleanable/blood/old{
	icon_state = "floor5-old"
	},
/obj/effect/decal/cleanable/dirt,
/turf/open/floor/plating/tunnel,
/area/f13/tunnel)
"Ca" = (
/obj/machinery/light/small{
	dir = 8;
	light_color = "#d8b1b1"
	},
/turf/open/floor/plating/tunnel,
/area/f13/tunnel)
"Cf" = (
/obj/structure/window/spawner/east{
	dir = 2
	},
/obj/item/conveyor_switch_construct,
/turf/open/floor/plating/tunnel,
/area/f13/tunnel)
"Cx" = (
/obj/structure/timeddoor/sixtyminute,
/turf/closed/wall/r_wall/f13/vault,
/area/f13/tunnel)
"CJ" = (
/mob/living/simple_animal/hostile/centaur,
/turf/open/floor/plating/tunnel,
/area/f13/tunnel)
"DW" = (
/turf/closed/wall/r_wall/rust,
/area/f13/tunnel)
"Er" = (
/obj/machinery/workbench/advanced,
/obj/item/book/granter/crafting_recipe/gunsmith_three,
/obj/item/book/granter/crafting_recipe/gunsmith_two,
/turf/open/floor/plasteel/f13/vault_floor/yellow,
/area/f13/tunnel)
"Ev" = (
/obj/effect/decal/cleanable/blood/old{
	icon_state = "floor1-old"
	},
/turf/open/indestructible/ground/inside/mountain,
/area/f13/tunnel)
"Fx" = (
/obj/machinery/light/small{
	dir = 1
	},
/mob/living/simple_animal/hostile/supermutant/rangedmutant,
/turf/open/floor/plasteel/grimy,
/area/f13/tunnel)
"Ga" = (
/obj/machinery/space_heater,
/turf/open/floor/plasteel/f13/vault_floor/yellow,
/area/f13/tunnel)
"Gb" = (
/mob/living/simple_animal/hostile/supermutant,
/turf/open/floor/plasteel/f13/vault_floor/yellow,
/area/f13/tunnel)
"Gr" = (
/obj/structure/simple_door/bunker,
/turf/open/floor/plasteel/grimy,
/area/f13/tunnel)
"GY" = (
/mob/living/simple_animal/hostile/stalkeryoung,
/turf/open/floor/plasteel/f13/vault_floor/yellow,
/area/f13/tunnel)
"Hb" = (
/obj/machinery/chem_master/advanced,
/turf/open/floor/plasteel/f13/vault_floor/yellow,
/area/f13/tunnel)
"Hi" = (
/obj/structure/rack,
/obj/structure/reagent_dispensers/watertank/high,
/turf/open/floor/plating/tunnel,
/area/f13/tunnel)
"Hu" = (
/mob/living/simple_animal/hostile/supermutant,
/turf/open/floor/plasteel/neutral,
/area/f13/tunnel)
"HK" = (
/obj/machinery/light/small{
	dir = 1
	},
/turf/open/floor/plasteel/grimy,
/area/f13/tunnel)
"Il" = (
/turf/closed/mineral/random/high_chance,
/area/f13/caves)
"In" = (
/turf/open/floor/plasteel/neutral/side{
	dir = 8
	},
/area/f13/tunnel)
"IO" = (
/obj/machinery/light/small{
	brightness = 3;
	dir = 8
	},
/mob/living/simple_animal/hostile/supermutant,
/turf/open/floor/plasteel/neutral/side{
	dir = 4
	},
/area/f13/tunnel)
"JC" = (
/obj/effect/decal/cleanable/dirt,
/obj/effect/decal/cleanable/blood/tracks{
	dir = 4
	},
/turf/open/floor/plating/tunnel,
/area/f13/tunnel)
"JN" = (
/obj/effect/decal/cleanable/dirt,
/obj/effect/decal/cleanable/blood/old{
	icon_state = "gib3-old"
	},
/turf/open/floor/f13{
	icon_state = "darkrusty"
	},
/area/f13/tunnel)
"JS" = (
/turf/open/floor/plasteel/f13/vault_floor/yellow,
/area/f13/tunnel)
"Kb" = (
/obj/item/storage/trash_stack,
/turf/open/indestructible/ground/inside/subway,
/area/f13/tunnel)
"KB" = (
/obj/structure/rack,
/obj/item/stack/sheet/metal/fifty,
/obj/item/stack/sheet/metal/fifty,
/obj/item/stack/sheet/metal/fifty,
/obj/item/stack/sheet/metal/fifty,
/obj/item/stack/sheet/metal/fifty,
/turf/open/floor/plating/tunnel,
/area/f13/tunnel)
"LU" = (
/turf/open/water,
/area/f13/tunnel)
"Mc" = (
/obj/structure/rack,
/obj/item/stack/sheet/metal/fifty,
/turf/open/floor/plasteel/f13/vault_floor/yellow,
/area/f13/tunnel)
"Mv" = (
/obj/structure/closet/crate/trashcart,
/obj/effect/spawner/lootdrop/f13/blueprintMid,
/turf/open/floor/plating/tunnel,
/area/f13/tunnel)
"Nb" = (
/obj/structure/safe,
/turf/open/floor/plating/tunnel,
/area/f13/tunnel)
"No" = (
/mob/living/simple_animal/hostile/supermutant,
/turf/open/floor/plasteel/neutral/side{
	dir = 10
	},
/area/f13/tunnel)
"Ns" = (
/turf/closed/wall/f13/ruins,
/area/f13/tunnel)
"NG" = (
/mob/living/simple_animal/hostile/supermutant/rangedmutant,
/turf/open/floor/plating/tunnel,
/area/f13/tunnel)
"NS" = (
/obj/structure/timeddoor,
/turf/open/indestructible/ground/inside/subway,
/area/f13/tunnel)
"NT" = (
/obj/machinery/door/window/southright,
/turf/open/floor/plating/tunnel,
/area/f13/tunnel)
"Oe" = (
/mob/living/simple_animal/hostile/supermutant,
/turf/open/floor/plating/tunnel,
/area/f13/tunnel)
"Of" = (
/obj/effect/decal/remains/human,
/obj/effect/decal/cleanable/dirt,
/turf/open/floor/plating/tunnel,
/area/f13/tunnel)
"OI" = (
/obj/structure/simple_door/bunker,
/obj/effect/decal/cleanable/dirt,
/obj/effect/decal/cleanable/blood/tracks{
	dir = 4
	},
/turf/open/floor/plating/tunnel,
/area/f13/tunnel)
"OU" = (
/obj/machinery/portable_atmospherics/pump,
/turf/open/floor/plating/tunnel,
/area/f13/tunnel)
"Pd" = (
/obj/machinery/light/small{
	dir = 1
	},
/turf/open/floor/plating/tunnel,
/area/f13/tunnel)
"Pl" = (
/obj/item/storage/trash_stack,
/turf/open/floor/plating/tunnel,
/area/f13/tunnel)
"Ps" = (
/turf/closed/wall/r_wall/rust,
/area/f13/caves)
"PJ" = (
/turf/open/floor/plasteel/neutral/side{
	dir = 4
	},
/area/f13/tunnel)
"PS" = (
/obj/structure/timeddoor,
/turf/closed/wall/r_wall/f13/vault,
/area/f13/tunnel)
"PW" = (
/obj/structure/closet/crate/trashcart{
	storage_capacity = 10
	},
/obj/effect/spawner/lootdrop/f13/weapon/gun/tier3,
/turf/open/floor/plating/tunnel,
/area/f13/tunnel)
"Qs" = (
/turf/open/floor/plating/tunnel,
/area/f13/tunnel)
"QF" = (
/obj/machinery/light/small{
	dir = 4
	},
/mob/living/simple_animal/hostile/supermutant/rangedmutant,
/turf/open/floor/plasteel/neutral/side{
	dir = 8
	},
/area/f13/tunnel)
"QO" = (
/mob/living/simple_animal/hostile/supermutant/legendary,
/turf/open/floor/plating/tunnel,
/area/f13/tunnel)
"QT" = (
/obj/machinery/portable_atmospherics/scrubber,
/turf/open/floor/plating/tunnel,
/area/f13/tunnel)
"QU" = (
/turf/closed/indestructible/rock,
/area/f13/caves)
"Rj" = (
/obj/effect/decal/cleanable/dirt,
/turf/open/floor/plating/tunnel,
/area/f13/tunnel)
"SR" = (
/obj/machinery/light/small{
	brightness = 3;
	dir = 8
	},
/turf/open/indestructible/ground/inside/subway,
/area/f13/tunnel)
"SZ" = (
/obj/machinery/conveyor/auto{
	dir = 4
	},
/obj/structure/plasticflaps,
/turf/open/floor/plating/tunnel,
/area/f13/tunnel)
"Tu" = (
/obj/effect/spawner/lootdrop/f13/blueprintMid,
/turf/open/floor/plating/tunnel,
/area/f13/tunnel)
"Tx" = (
/obj/effect/spawner/lootdrop/f13/medical/vault/meds,
/turf/open/floor/plasteel/grimy,
/area/f13/tunnel)
"TD" = (
/obj/machinery/light/small{
	dir = 4
	},
/turf/open/floor/plasteel/neutral/side{
	dir = 8
	},
/area/f13/tunnel)
"TP" = (
/obj/structure/barricade/sandbags,
/turf/open/floor/plasteel/neutral/side{
	dir = 4
	},
/area/f13/tunnel)
"TX" = (
/obj/structure/window/spawner/east{
	dir = 2
	},
/turf/open/floor/plating/tunnel,
/area/f13/tunnel)
"Uj" = (
/obj/structure/closet/crate/trashcart,
/obj/effect/spawner/lootdrop/f13/armor/tier4,
/obj/effect/spawner/lootdrop/f13/blueprintHigh,
/obj/effect/spawner/lootdrop/f13/blueprintHigh,
/turf/open/floor/plating/tunnel,
/area/f13/tunnel)
"UM" = (
/obj/structure/reagent_dispensers/cooking_oil,
/turf/open/floor/plating/tunnel,
/area/f13/tunnel)
"UX" = (
/obj/structure/table/wood/settler,
/obj/machinery/recharger,
/turf/open/floor/plasteel/f13/vault_floor/yellow,
/area/f13/tunnel)
"Vl" = (
/obj/item/storage/trash_stack,
/obj/effect/decal/waste,
/turf/open/floor/plating/tunnel,
/area/f13/tunnel)
"VK" = (
/obj/machinery/conveyor/auto{
	dir = 4
	},
/turf/open/floor/plating/tunnel,
/area/f13/tunnel)
"VM" = (
/obj/structure/closet/crate/trashcart,
/obj/effect/spawner/lootdrop/f13/weapon/gun/tier2,
/obj/effect/spawner/lootdrop/f13/blueprintMid,
/turf/open/floor/plating/tunnel,
/area/f13/tunnel)
"VP" = (
/mob/living/simple_animal/hostile/deathclaw,
/turf/open/water,
/area/f13/tunnel)
"VV" = (
/obj/machinery/workbench/forge,
/turf/open/floor/plating/tunnel,
/area/f13/tunnel)
"Wl" = (
/obj/machinery/recycler,
/obj/machinery/conveyor/auto{
	dir = 4
	},
/turf/open/floor/plating/tunnel,
/area/f13/tunnel)
"Wq" = (
/obj/effect/spawner/lootdrop/f13/weapon/melee/random_high,
/turf/open/floor/plating/tunnel,
/area/f13/tunnel)
"Xm" = (
/obj/structure/closet/crate/trashcart,
/obj/effect/spawner/lootdrop/f13/weapon/gun/random,
/turf/open/floor/plating/tunnel,
/area/f13/tunnel)
"XD" = (
/obj/effect/decal/remains/human,
/obj/effect/decal/cleanable/dirt,
/obj/effect/decal/cleanable/dirt,
/obj/effect/decal/cleanable/dirt,
/turf/open/floor/f13{
	icon_state = "darkrusty"
	},
/area/f13/tunnel)
"XF" = (
/obj/effect/decal/cleanable/dirt,
/obj/effect/decal/cleanable/blood/tracks{
	dir = 4
	},
/turf/open/indestructible/ground/inside/mountain,
/area/f13/tunnel)
"Yc" = (
/obj/structure/reagent_dispensers/fueltank,
/turf/open/floor/plasteel/f13/vault_floor/yellow,
/area/f13/tunnel)
"Yj" = (
/mob/living/simple_animal/hostile/supermutant,
/turf/open/floor/plasteel/neutral/side{
	dir = 4
	},
/area/f13/tunnel)
"Yr" = (
/obj/structure/simple_door/bunker,
/obj/structure/timeddoor/sixtyminute,
/obj/machinery/door/poddoor{
	id = "pain"
	},
/turf/open/water,
/area/f13/tunnel)
"YH" = (
/obj/machinery/light/small{
	dir = 1
	},
/obj/machinery/space_heater,
/turf/open/floor/plasteel/f13/vault_floor/yellow,
/area/f13/tunnel)
"YQ" = (
/obj/machinery/light/small,
/obj/structure/window/spawner/east,
/obj/effect/decal/waste{
	icon_state = "goo5"
	},
/turf/open/floor/plating/tunnel,
/area/f13/tunnel)
"Zh" = (
/obj/machinery/light/small,
/obj/structure/rack,
/obj/item/stack/sheet/glass/fifty,
/turf/open/floor/plasteel/f13/vault_floor/yellow,
/area/f13/tunnel)
"Zk" = (
/obj/structure/reagent_dispensers/barrel/dangerous,
/turf/open/floor/plating/tunnel,
/area/f13/tunnel)
"ZL" = (
/obj/effect/decal/cleanable/dirt,
/turf/open/indestructible/ground/inside/mountain,
/area/f13/tunnel)

(1,1,1) = {"
BH
BH
BH
BH
BH
BH
BH
BH
QU
QU
QU
QU
QU
QU
QU
QU
QU
QU
QU
QU
BH
QU
QU
BH
qz
qz
BH
qz
BH
QU
BH
BH
BH
BH
BH
BH
"}
(2,1,1) = {"
BH
BH
BH
BH
BH
BH
BH
BH
QU
iY
iY
iY
iY
iY
iY
iY
iY
iY
iY
QU
BH
BH
QU
BH
BH
qz
BH
qz
BH
QU
BH
BH
BH
BH
BH
BH
"}
(3,1,1) = {"
BH
BH
BH
BH
BH
BH
BH
BH
QU
iY
UM
Pl
Qs
Uj
Ca
Pl
Qs
Vl
iY
QU
BH
BH
QU
QU
BH
qz
qz
BH
BH
QU
BH
BH
BH
BH
QU
QU
"}
(4,1,1) = {"
BH
BH
BH
BH
BH
BH
BH
BH
QU
iY
UM
Qs
CJ
Qs
iu
zV
Pl
Zk
iY
QU
BH
BH
BH
QU
BH
BH
qz
BH
BH
QU
BH
BH
BH
BH
QU
BH
"}
(5,1,1) = {"
BH
BH
BH
BH
BH
BH
BH
BH
QU
iY
pb
Pl
Pl
Qs
Zk
Qs
Qs
Xm
iY
QU
BH
BH
BH
QU
QU
BH
qz
qz
BH
QU
QU
QU
QU
QU
QU
BH
"}
(6,1,1) = {"
BH
BH
BH
BH
BH
BH
BH
BH
QU
iY
Pd
qY
Qs
Pl
Pl
Qs
Pl
qv
iY
QU
BH
BH
BH
BH
QU
BH
BH
qz
BH
BH
BH
BH
BH
BH
BH
BH
"}
(7,1,1) = {"
BH
BH
BH
BH
BH
BH
BH
BH
QU
iY
Zk
Pl
lw
Qs
Qs
Qs
CJ
lW
iY
QU
BH
BH
BH
BH
QU
QU
BH
qz
qz
BH
BH
qz
qz
qz
BH
qz
"}
(8,1,1) = {"
BH
BH
BH
BH
BH
BH
BH
BH
QU
iY
CJ
Qs
Xm
VK
Qs
Zk
Nb
Mv
iY
QU
BH
BH
BH
BH
BH
QU
BH
BH
qz
qz
BH
jG
qz
qz
qz
qz
"}
(9,1,1) = {"
BH
BH
BH
BH
BH
BH
BH
BH
QU
iY
iY
iY
iY
SZ
iY
iY
iY
iY
iY
QU
BH
BH
BH
BH
BH
QU
QU
BH
BH
qz
qz
qz
qz
BH
BH
BH
"}
(10,1,1) = {"
BH
BH
BH
BH
BH
BH
BH
BH
QU
QU
QU
QU
iY
VK
iY
QU
QU
QU
QU
QU
BH
BH
BH
BH
BH
BH
QU
QU
BH
BH
BH
BH
BH
BH
QU
QU
"}
(11,1,1) = {"
BH
BH
BH
BH
BH
BH
BH
BH
BH
BH
BH
QU
iY
VK
iY
QU
BH
BH
BH
BH
BH
BH
BH
BH
BH
BH
BH
QU
QU
QU
QU
QU
QU
QU
QU
BH
"}
(12,1,1) = {"
BH
BH
BH
BH
BH
BH
BH
BH
BH
BH
BH
QU
iY
VK
iY
QU
BH
BH
BH
BH
BH
BH
BH
BH
BH
BH
BH
BH
BH
BH
BH
BH
BH
BH
BH
BH
"}
(13,1,1) = {"
QU
QU
QU
QU
QU
QU
QU
QU
QU
QU
QU
QU
iY
VK
iY
QU
BH
BH
BH
BH
BH
BH
BH
BH
BH
BH
BH
BH
BH
BH
BH
BH
BH
BH
BH
BH
"}
(14,1,1) = {"
QU
iY
iY
iY
iY
iY
vE
iY
iY
iY
iY
iY
iY
SZ
iY
QU
BH
BH
BH
BH
BH
BH
BH
BH
BH
BH
BH
BH
BH
BH
BH
BH
BH
BH
BH
BH
"}
(15,1,1) = {"
QU
iY
HK
Tx
iY
Pd
Qs
aD
iY
rQ
VM
PW
mj
VK
iY
QU
BH
BH
BH
BH
BH
BH
BH
BH
BH
BH
BH
BH
BH
BH
BH
BH
BH
BH
BH
BH
"}
(16,1,1) = {"
QU
iY
uT
rU
iY
Qs
NG
Qs
iY
Qs
Qs
Qs
TX
VK
iY
QU
BH
BH
BH
BH
BH
BH
BH
BH
BH
BH
BH
BH
BH
BH
BH
BH
BH
BH
BH
BH
"}
(17,1,1) = {"
QU
iY
rU
rU
hA
Qs
QO
Qs
hA
Qs
CJ
CJ
Cf
kz
iY
QU
BH
BH
BH
BH
BH
BH
BH
BH
BH
BH
BH
BH
BH
BH
BH
BH
BH
BH
BH
BH
"}
(18,1,1) = {"
QU
iY
AS
rU
iY
Qs
NG
Qs
iY
eA
Qs
CJ
TX
Wl
iY
QU
BH
BH
BH
BH
BH
BH
BH
BH
BH
BH
BH
BH
BH
BH
BH
BH
BH
BH
BH
BH
"}
(19,1,1) = {"
QU
iY
Tx
rU
iY
Pd
aD
Qs
iY
wt
wM
wM
mj
VK
iY
QU
BH
BH
BH
BH
BH
BH
BH
BH
BH
BH
BH
BH
BH
BH
BH
BH
BH
BH
BH
BH
"}
(20,1,1) = {"
QU
iY
Fx
Tx
iY
iY
iY
iY
iY
iY
iY
iY
iY
mU
iY
QU
BH
BH
BH
BH
BH
BH
BH
BH
BH
BH
BH
BH
BH
BH
BH
BH
BH
BH
BH
BH
"}
(21,1,1) = {"
QU
iY
rU
rU
iY
eW
JS
Mc
iY
kG
qb
KB
qv
Qs
iY
QU
BH
BH
BH
BH
BH
BH
BH
BH
BH
BH
BH
BH
BH
BH
BH
BH
BH
BH
BH
BH
"}
(22,1,1) = {"
QU
iY
rU
rU
iY
Hb
Gb
Zh
iY
Qs
nz
Qs
QO
Qs
iY
QU
BH
BH
BH
BH
BH
BH
BH
BH
BH
BH
BH
BH
BH
BH
BH
BH
BH
BH
BH
BH
"}
(23,1,1) = {"
QU
iY
rU
rU
iY
Yc
JS
fZ
iY
Hi
Hi
Hi
Qs
Qs
iY
QU
QU
BH
BH
BH
BH
BH
BH
BH
BH
BH
BH
BH
BH
BH
BH
BH
BH
BH
BH
BH
"}
(24,1,1) = {"
QU
iY
Gr
iY
iY
iY
lE
iY
iY
iY
iY
iY
iY
hA
iY
iY
PS
wI
wI
wI
wI
wI
wI
wI
wI
wI
wI
wI
Ns
Ns
Ns
Ns
Ns
Ns
Ns
Ns
"}
(25,1,1) = {"
QU
iY
No
PJ
vD
nU
PJ
PJ
pG
TP
Yj
PJ
IO
us
kE
mZ
NS
kE
kE
kE
SR
kE
kE
kE
kE
kE
kE
kE
Kb
kE
kE
kE
kE
kE
kE
SR
"}
(26,1,1) = {"
QU
iY
pi
sw
sw
gM
sw
Hu
sw
gM
sw
sw
sw
Hu
kE
kE
NS
kE
kE
kE
kE
kE
kE
Kb
kE
kE
kE
kE
kE
kE
kE
kE
kE
kE
kE
kE
"}
(27,1,1) = {"
QU
iY
pJ
In
TD
pS
In
In
QF
wj
kt
In
wO
za
kE
mZ
NS
kE
kE
kE
kE
kE
kE
kE
kE
kE
kE
kE
kE
kE
kE
kE
kE
kE
kE
Kb
"}
(28,1,1) = {"
QU
iY
Gr
iY
iY
iY
nd
iY
iY
iY
iY
iY
iY
iY
iY
iY
PS
wI
wI
wI
wI
wI
wI
wI
wI
wI
wI
wI
Ns
Ns
Ns
lE
Ns
Ns
Ns
Ns
"}
(29,1,1) = {"
QU
iY
rU
rU
iY
Qs
Qs
Qs
iY
VV
Qs
Qs
Qs
Qs
iY
QU
QU
BH
BH
BH
BH
BH
BH
BH
BH
BH
BH
BH
Ns
Ga
JS
JS
JS
UX
Ns
BH
"}
(30,1,1) = {"
QU
iY
rU
Tx
iY
Qs
Oe
bS
iY
Qs
Qs
Qs
Qs
Qs
iY
QU
BH
BH
BH
BH
BH
BH
BH
BH
BH
BH
BH
BH
Ns
YH
lz
GY
lz
Bu
Ns
BH
"}
(31,1,1) = {"
QU
iY
rU
mT
iY
Oe
Qs
Qs
iY
Qs
Qs
Qs
Qs
Qs
iY
QU
BH
BH
BH
BH
BH
BH
BH
BH
BH
BH
BH
BH
Ns
cQ
JS
JS
JS
Er
Ns
BH
"}
(32,1,1) = {"
QU
iY
Fx
rU
iY
iY
iY
iY
iY
iY
iY
iY
iY
iY
iY
QU
BH
BH
BH
BH
BH
BH
BH
BH
BH
BH
BH
BH
Ns
Ns
Ns
Ns
Ns
Ns
Ns
BH
"}
(33,1,1) = {"
QU
iY
Tx
Tx
iY
Pd
Qs
Qs
iY
AR
qY
wr
QT
QT
iY
QU
BH
BH
BH
BH
BH
BH
BH
BH
BH
BH
BH
BH
BH
BH
BH
BH
BH
BH
BH
BH
"}
(34,1,1) = {"
QU
iY
AS
rU
iY
Qs
NG
Oe
iY
hL
Qs
Wq
CJ
Tu
iY
QU
BH
BH
BH
BH
BH
BH
BH
BH
BH
BH
QU
QU
QU
QU
QU
BH
BH
BH
BH
BH
"}
(35,1,1) = {"
QU
iY
rU
rU
hA
Qs
Qs
Qs
hA
Wq
CJ
Qs
va
YQ
iY
QU
BH
BH
BH
BH
BH
BH
BH
BH
QU
QU
DW
DW
DW
BH
BH
QU
QU
BH
BH
BH
"}
(36,1,1) = {"
QU
iY
uT
rU
iY
Qs
NG
Oe
iY
iu
qv
NT
LU
LU
iY
QU
BH
BH
BH
BH
BH
BH
QU
QU
BH
BH
DW
pK
mR
nD
BH
BH
BH
QU
BH
BH
"}
(37,1,1) = {"
QU
iY
dx
Tx
iY
Pd
Qs
Qs
iY
gC
OU
mj
LU
LU
iY
QU
QU
BH
BH
BH
BH
QU
BH
BH
BH
aS
DW
ew
Of
Aw
pa
DW
BH
QU
BH
BH
"}
(38,1,1) = {"
QU
iY
iY
iY
iY
iY
iY
iY
iY
iY
iY
Cx
Cx
Yr
Cx
BH
QU
BH
BH
BH
BH
QU
BH
wa
qz
Ev
ZL
Rj
Rj
dP
tO
DW
BH
BH
QU
BH
"}
(39,1,1) = {"
QU
QU
QU
QU
QU
QU
QU
QU
QU
QU
QU
BH
BH
LU
LU
BH
QU
BH
BH
BH
BH
QU
BH
aS
qz
ZL
ZL
Rj
lM
Rj
Rj
BQ
ZL
BH
BH
QU
"}
(40,1,1) = {"
BH
BH
BH
BH
BH
BH
BH
BH
BH
BH
QU
BH
BH
LU
LU
BH
QU
BH
BH
BH
BH
QU
BH
BH
fj
aS
DW
vA
Rj
Rj
XD
DW
qz
aS
BH
QU
"}
(41,1,1) = {"
BH
BH
BH
BH
BH
BH
BH
BH
BH
BH
QU
BH
BH
LU
BH
QU
QU
QU
QU
QU
BH
BH
QU
BH
aS
wI
DW
jl
JC
hF
JN
Rj
ZL
BH
BH
QU
"}
(42,1,1) = {"
BH
BH
BH
BH
BH
BH
BH
BH
BH
QU
BH
BH
LU
LU
BH
QU
BH
BH
BH
BH
QU
BH
QU
BH
BH
BH
DW
DW
OI
DW
DW
DW
BH
BH
QU
BH
"}
(43,1,1) = {"
BH
BH
BH
BH
BH
BH
BH
BH
QU
BH
BH
LU
LU
BH
QU
BH
BH
LU
LU
BH
BH
QU
BH
QU
QU
QU
BH
BH
XF
BH
BH
QU
QU
QU
BH
BH
"}
(44,1,1) = {"
BH
BH
BH
BH
BH
BH
BH
BH
QU
BH
LU
LU
BH
QU
BH
BH
LU
VP
LU
LU
BH
BH
QU
BH
BH
BH
DW
gJ
gb
DW
QU
BH
BH
BH
BH
BH
"}
(45,1,1) = {"
BH
BH
BH
BH
BH
BH
BH
BH
QU
BH
LU
BH
BH
QU
BH
LU
LU
LU
LU
LU
LU
BH
BH
QU
BH
BH
DW
es
DW
DW
QU
BH
BH
BH
BH
BH
"}
(46,1,1) = {"
BH
BH
BH
BH
BH
BH
BH
BH
QU
BH
LU
BH
BH
BH
BH
LU
LU
BH
BH
LU
LU
LU
BH
QU
BH
BH
DW
iC
pV
BH
QU
BH
BH
BH
BH
BH
"}
(47,1,1) = {"
BH
BH
BH
BH
BH
BH
BH
BH
QU
BH
LU
LU
BH
BH
LU
LU
qz
BH
QU
BH
LU
LU
BH
BH
QU
QU
BH
BH
es
DW
BH
QU
QU
BH
BH
BH
"}
(48,1,1) = {"
BH
BH
BH
BH
BH
BH
BH
BH
QU
BH
LU
VP
LU
LU
LU
qz
BH
BH
QU
BH
LU
LU
sZ
Ps
QU
BH
BH
qz
es
dM
BH
BH
BH
QU
BH
BH
"}
(49,1,1) = {"
BH
BH
BH
BH
BH
BH
BH
BH
QU
BH
qz
LU
LU
LU
qz
BH
BH
QU
BH
LU
LU
LU
qz
BH
QU
BH
qz
qz
LU
LU
qz
zs
BH
BH
QU
BH
"}
(50,1,1) = {"
BH
BH
BH
BH
BH
BH
BH
BH
QU
BH
BH
qz
rm
qz
BH
BH
QU
BH
qz
LU
yY
qz
BH
QU
BH
qz
qz
LU
LU
LU
LU
aS
qz
BH
BH
QU
"}
(51,1,1) = {"
BH
Il
Il
BH
BH
BH
BH
BH
BH
QU
BH
BH
DW
BH
BH
QU
BH
qz
qz
LU
LU
qz
BH
QU
BH
qz
VP
LU
LU
LU
LU
fU
qz
qz
BH
QU
"}
(52,1,1) = {"
Il
Il
Il
BH
BH
BH
Il
Il
BH
BH
QU
QU
QU
QU
QU
QU
BH
qz
LU
LU
LU
aS
BH
BH
qz
qz
LU
LU
LU
LU
LU
LU
qz
qz
BH
QU
"}
(53,1,1) = {"
Il
Il
Il
BH
BH
BH
Il
Il
BH
BH
BH
BH
BH
BH
BH
QU
BH
qz
LU
LU
LU
BH
BH
BH
qz
LU
LU
LU
LU
LU
LU
LU
qz
qz
BH
QU
"}
(54,1,1) = {"
Il
Il
Il
Il
BH
BH
Il
Il
BH
BH
BH
Il
BH
BH
BH
QU
BH
qz
LU
LU
LU
qz
qz
LU
LU
LU
LU
LU
LU
LU
LU
LU
qz
zs
BH
QU
"}
(55,1,1) = {"
Il
Il
Il
BH
BH
BH
BH
BH
BH
BH
BH
Il
BH
BH
BH
QU
BH
BH
qz
LU
LU
LU
LU
LU
LU
LU
LU
LU
LU
LU
LU
LU
qz
qz
BH
QU
"}
(56,1,1) = {"
Il
Il
Il
BH
BH
BH
Il
Il
BH
BH
Il
Il
Il
BH
BH
BH
QU
BH
qz
VP
LU
LU
LU
LU
LU
qz
VP
LU
LU
LU
LU
fU
qz
BH
BH
QU
"}
(57,1,1) = {"
BH
BH
Il
BH
BH
BH
BH
BH
BH
BH
Il
Il
Il
BH
BH
BH
QU
BH
qz
qz
LU
LU
LU
qz
rm
qz
qz
qz
LU
LU
qz
qz
BH
BH
QU
BH
"}
(58,1,1) = {"
BH
BH
Il
BH
BH
BH
BH
BH
BH
BH
Il
Il
Il
BH
BH
BH
QU
BH
BH
qz
qz
qz
qz
qz
DW
BH
qz
qz
qz
qz
qz
BH
BH
QU
BH
BH
"}
(59,1,1) = {"
BH
BH
BH
BH
BH
BH
BH
BH
BH
BH
Il
BH
Il
BH
BH
BH
BH
QU
BH
BH
BH
BH
BH
BH
BH
BH
BH
BH
BH
BH
BH
BH
QU
BH
BH
BH
"}
(60,1,1) = {"
BH
BH
BH
BH
BH
BH
BH
BH
BH
BH
Il
BH
Il
BH
BH
BH
BH
BH
QU
QU
QU
QU
QU
QU
QU
QU
QU
QU
QU
QU
QU
QU
BH
BH
BH
BH
"}
