"ck" = (/obj/structure/barricade/sandbags,/turf/open/indestructible/ground/inside/subway,/area/f13/subway)
"cA" = (/mob/living/simple_animal/hostile/supermutant/nightkin/elitemutant,/turf/open/indestructible/ground/inside/subway,/area/f13/subway)
"cQ" = (/obj/structure/closet/radiation,/turf/open/floor/plasteel/f13/vault_floor/yellow,/area/f13/tunnel)
"jG" = (/mob/living/simple_animal/hostile/radscorpion/black,/turf/open/indestructible/ground/inside/mountain,/area/f13/tunnel)
"kE" = (/turf/open/indestructible/ground/inside/subway,/area/f13/tunnel)
"lz" = (/mob/living/simple_animal/hostile/stalker,/turf/open/floor/plasteel/f13/vault_floor/yellow,/area/f13/tunnel)
"lE" = (/obj/structure/simple_door/bunker,/turf/open/floor/plasteel/f13/vault_floor/yellow,/area/f13/tunnel)
"mZ" = (/obj/structure/barricade/sandbags,/turf/open/indestructible/ground/inside/subway,/area/f13/tunnel)
"qz" = (/turf/open/indestructible/ground/inside/mountain,/area/f13/tunnel)
"qQ" = (/mob/living/simple_animal/hostile/supermutant/rangedmutant,/turf/open/indestructible/ground/inside/subway,/area/f13/subway)
"wI" = (/turf/closed/mineral/random/low_chance,/area/f13/tunnel)
"Bu" = (/obj/machinery/light/small,/obj/structure/table/wood/settler,/obj/machinery/cell_charger,/turf/open/floor/plasteel/f13/vault_floor/yellow,/area/f13/tunnel)
"BH" = (/turf/closed/mineral/random/low_chance,/area/f13/caves)
"Er" = (/obj/machinery/workbench/advanced,/obj/item/book/granter/crafting_recipe/gunsmith_three,/obj/item/book/granter/crafting_recipe/gunsmith_two,/turf/open/floor/plasteel/f13/vault_floor/yellow,/area/f13/tunnel)
"Ga" = (/obj/machinery/space_heater,/turf/open/floor/plasteel/f13/vault_floor/yellow,/area/f13/tunnel)
"GY" = (/mob/living/simple_animal/hostile/stalkeryoung,/turf/open/floor/plasteel/f13/vault_floor/yellow,/area/f13/tunnel)
"JS" = (/turf/open/floor/plasteel/f13/vault_floor/yellow,/area/f13/tunnel)
"Kb" = (/obj/item/storage/trash_stack,/turf/open/indestructible/ground/inside/subway,/area/f13/tunnel)
"Ns" = (/turf/closed/wall/f13/ruins,/area/f13/tunnel)
"NS" = (/obj/structure/timeddoor,/turf/open/indestructible/ground/inside/subway,/area/f13/tunnel)
"OT" = (/obj/effect/spawner/lootdrop/f13/weapon/gun/tier4,/turf/open/indestructible/ground/inside/subway,/area/f13/subway)
"PS" = (/obj/structure/timeddoor,/turf/closed/wall/r_wall/f13/vault,/area/f13/tunnel)
"QU" = (/turf/closed/indestructible/rock,/area/f13/caves)
"SR" = (/obj/machinery/light/small{brightness = 3; dir = 8},/turf/open/indestructible/ground/inside/subway,/area/f13/tunnel)
"SW" = (/obj/effect/spawner/lootdrop/f13/armor/tier4,/turf/open/indestructible/ground/inside/subway,/area/f13/subway)
"Tq" = (/mob/living/simple_animal/hostile/supermutant,/turf/open/indestructible/ground/inside/subway,/area/f13/subway)
"UX" = (/obj/structure/table/wood/settler,/obj/machinery/recharger,/turf/open/floor/plasteel/f13/vault_floor/yellow,/area/f13/tunnel)
"Yn" = (/mob/living/simple_animal/hostile/supermutant/nightkin/rangedmutant,/turf/open/indestructible/ground/inside/subway,/area/f13/subway)
"YH" = (/obj/machinery/light/small{dir = 1},/obj/machinery/space_heater,/turf/open/floor/plasteel/f13/vault_floor/yellow,/area/f13/tunnel)
"ZL" = (/turf/open/indestructible/ground/inside/subway,/area/f13/subway)
"ZN" = (/obj/effect/spawner/lootdrop/f13/blueprintMid,/turf/open/indestructible/ground/inside/subway,/area/f13/subway)

(1,1,1) = {"
QUQUQUQUQUQUQUQUQUQUQUQUQUQUQUQUQUQUQUQUQUQUQUQUQUQUQUQUQUQUQUQUQUQUQUQUQUQUQUQUQUQUQUQUQUQUQUQUQUQUQUQUQUQUQUQUQUQUQUQU
QUZLZLZLZLZLZLZLZLZLZLBHBHBHQUBHBHBHBHBHBHBHBHBHBHBHBHBHBHBHBHBHBHBHBHBHBHBHBHBHBHBHBHBHBHBHBHBHBHBHBHBHBHBHBHBHBHBHBHQU
QUZLZLZLZLZLZLZLZLZLZLBHBHBHQUBHBHBHBHBHBHBHBHBHZLZLZLBHBHBHBHBHBHBHBHBHBHBHBHBHBHBHBHBHBHBHBHBHBHBHBHBHBHBHBHBHBHBHBHQU
QUZLZLZLZLZNZLZLZLZLZLBHBHBHQUBHBHBHBHBHBHBHBHBHZLZLZLBHBHBHBHBHBHBHBHBHBHBHBHBHBHBHBHBHBHBHBHBHBHBHBHBHBHBHBHBHBHBHBHQU
QUZLZLZLZLZLZLZLZLZLqQBHBHBHQUBHBHBHBHBHBHBHBHBHZLZLZLBHBHBHBHBHBHBHBHBHBHBHBHBHBHBHBHBHBHBHBHBHBHBHBHBHBHBHBHBHBHBHBHQU
QUBHBHBHBHBHBHBHBHBHckBHBHBHQUBHBHBHBHBHBHBHBHBHZLZLZLBHBHBHBHBHBHBHBHBHBHBHBHBHBHBHBHBHBHBHBHBHBHBHBHBHBHBHBHBHBHBHBHQU
QUQUQUQUQUQUQUQUQUBHZLBHBHBHQUBHBHBHBHBHBHBHBHBHZLZLZLBHBHBHBHBHBHBHBHBHBHBHBHBHBHBHBHBHBHBHBHBHBHBHBHBHBHBHBHBHBHBHBHQU
BHBHBHBHBHBHBHBHQUBHZLBHBHBHBHBHBHBHBHBHBHBHBHBHZLZLZLBHBHBHBHBHBHBHBHBHBHBHBHBHBHBHBHBHBHBHBHBHBHBHBHBHBHBHBHBHBHBHBHQU
BHBHBHBHBHBHBHBHQUBHZLckZLZLZLZLZLZLZLZLZLZLqQckZLZLZLckqQZLZLZLZLZLZLZLZLZLZLZLZLZLBHBHBHBHBHBHBHBHBHBHBHBHBHBHBHBHBHQU
BHBHBHBHBHBHQUQUQUBHZLBHBHBHBHBHZLZLZLZLZLZLqQckZLZLZLckqQZLZLZLBHBHBHZLZLBHBHBHBHZLBHBHBHBHBHBHBHBHBHBHBHBHBHBHBHBHBHQU
BHBHBHBHBHBHQUBHBHBHckBHBHBHQUBHBHBHBHBHBHBHBHBHZLTqZLZLBHBHBHBHBHBHBHZLZLBHQUBHBHZLBHBHBHBHBHBHBHBHBHBHBHBHBHBHBHBHBHQU
BHBHBHBHBHBHQUBHZLZLqQZLZLBHQUBHBHBHBHBHBHBHBHBHTqZLZLBHBHBHBHBHBHBHBHZLZLBHQUBHBHZLBHBHBHBHBHBHBHBHBHBHBHBHBHBHBHBHBHQU
BHBHBHBHBHBHQUBHZLZLZLZLZLBHQUBHBHBHBHBHBHBHBHBHZLZLTqBHBHBHBHBHBHBHBHZLZLBHQUBHBHckBHBHBHBHBHBHBHBHBHBHBHBHBHBHBHBHBHQU
BHBHBHBHBHBHQUBHZLZLZLZLZLBHQUBHBHBHBHBHBHBHBHBHZLZLZLBHBHBHBHBHBHBHBHZLZLBHQUBHZLZLZLZLZLZLZLZLBHBHBHBHBHBHBHBHBHBHBHQU
BHBHBHBHBHBHQUBHZLOTZLZLZLBHQUBHBHBHBHBHBHBHBHBHZLZLZLBHBHBHBHBHBHBHBHZLZLBHQUBHZLZLZLZLZLZLZLZLBHBHBHBHBHBHBHBHBHBHBHQU
BHBHBHBHBHBHQUBHBHBHBHBHBHBHQUBHBHBHBHBHBHBHBHPSmZkEmZPSBHBHBHBHBHBHBHZLBHBHQUBHZLZLZLZLZLZLZLZLckZLZLZLBHBHBHBHBHBHBHQU
BHBHBHBHBHBHQUBHBHBHBHBHBHBHQUBHBHBHBHBHBHBHBHPSNSNSNSPSBHBHBHBHBHBHBHZLBHBHQUBHZLZLZLZLZLZLZLZLBHBHBHZLBHBHBHBHBHBHBHQU
BHBHBHBHBHBHQUQUQUQUQUQUQUQUQUQUQUQUQUQUQUQUQUwIkEkEkEwIQUQUQUQUQUBHBHZLBHBHQUBHckckZLZLZLZLZLZLBHQUBHZLBHBHBHBHBHBHBHQU
BHBHBHBHBHBHBHBHBHBHBHBHBHBHBHBHBHBHBHBHBHBHBHwIkEkEkEwIBHBHBHBHQUBHBHZLBHBHQUBHYnZLZLZLZLZLZLZLBHQUBHZLBHBHBHBHBHBHBHQU
BHBHBHBHBHBHBHBHBHBHBHBHBHBHBHBHBHBHBHBHBHBHBHwIkEkEkEwIBHBHBHBHQUBHBHZLBHBHQUBHSWZLZLckZLZLZLZLBHQUBHZLBHBHBHBHBHBHBHQU
BHBHBHBHBHBHBHBHBHBHBHBHBHBHBHBHBHBHBHBHBHBHBHwISRkEkEwIBHBHBHBHQUBHBHckZLBHQUBHZLZLZLYnckZLZLZLBHQUBHZLBHBHBHBHBHBHBHQU
QUBHBHBHBHBHBHBHBHBHBHBHBHBHBHBHBHBHBHBHBHBHBHwIkEkEkEwIBHBHBHBHQUBHBHZLckBHQUBHBHBHBHBHBHBHBHBHBHQUBHZLBHBHBHBHBHBHBHQU
QUQUQUBHBHBHBHBHBHBHBHBHBHBHBHBHBHBHBHBHBHBHBHwIkEkEkEwIBHBHBHBHQUBHBHBHZLBHQUQUQUQUQUQUQUQUQUQUQUQUBHZLBHBHQUQUQUQUQUQU
BHBHQUQUQUBHBHBHBHBHBHBHBHBHBHBHBHBHBHBHBHBHBHwIkEKbkEwIBHBHBHBHQUBHBHBHZLBHBHBHBHBHBHBHBHBHBHBHBHBHBHZLBHBHBHBHBHBHBHQU
qzBHBHBHQUQUQUBHBHBHBHBHBHBHBHBHBHBHBHBHBHBHBHwIkEkEkEwIBHBHBHBHQUBHBHBHZLBHBHBHBHBHBHBHBHBHBHBHBHBHBHZLZLZLBHBHZLZLZLQU
qzqzqzBHBHBHQUQUQUBHBHBHBHBHBHBHBHBHBHBHBHBHBHwIkEkEkEwIBHBHBHBHQUBHBHBHZLZLZLZLZLZLZLZLZLZLZLZLZLZLZLZLZLZLZLckcAZNZLQU
BHBHqzqzqzBHBHBHQUQUBHBHBHBHBHBHBHBHBHBHBHBHBHwIkEkEkEwIBHBHBHBHQUBHBHBHZLBHBHBHBHBHBHBHBHBHBHBHBHBHBHBHBHBHBHBHZLZLZLQU
qzqzBHBHqzqzqzBHBHQUQUBHBHBHBHBHBHBHBHBHBHBHBHwIkEkEkEwIBHBHBHBHQUBHBHBHZLBHQUQUQUQUQUQUQUBHBHBHBHBHBHBHBHBHQUBHZLZLZLQU
BHBHBHBHBHBHqzqzBHBHQUBHBHBHBHBHBHBHBHBHBHBHBHNsKbkEkENsNsNsNsNsQUBHBHBHZLBHBHBHBHBHBHBHQUBHBHBHBHBHBHBHBHBHQUBHZLZLZLQU
QUQUQUQUQUBHBHqzqzBHQUBHBHBHBHBHBHBHBHBHBHBHBHNskEkEkENsGaYHcQNsQUBHBHBHZLBHZLZLZLZLZLBHQUBHBHBHBHBHBHBHBHBHQUBHBHBHBHQU
BHBHBHBHQUBHBHBHqzBHQUBHBHBHBHBHBHBHBHBHBHBHBHNskEkEkENsJSlzJSNsQUBHBHBHZLZLckZLZLcAZLBHQUBHBHBHBHBHBHBHBHBHQUQUQUQUQUQU
BHBHBHBHQUBHqzjGqzBHQUBHBHBHBHBHBHBHBHBHBHBHBHNskEkEkElEJSGYJSNsQUBHBHBHBHBHZLckZLZLZLBHQUBHBHBHBHBHBHBHBHBHBHBHBHBHBHQU
BHBHBHBHQUBHqzqzqzBHQUBHBHBHBHBHBHBHBHBHBHBHBHNskEkEkENsJSlzJSNsQUBHBHBHQUBHZLZLZLZLZLBHQUBHBHBHBHBHBHBHBHBHBHBHBHBHBHQU
BHBHBHBHQUBHqzqzBHBHQUBHBHBHBHBHBHBHBHBHBHBHBHNskEkEkENsUXBuErNsQUQUQUQUQUQUQUQUQUQUQUQUQUQUQUQUQUQUQUQUQUQUQUQUQUQUQUQU
BHBHQUQUQUBHBHqzBHQUQUBHBHBHBHBHBHBHBHBHBHBHBHNskEkEkENsNsNsNsNsBHBHBHBHBHBHBHBHBHBHBHBHBHBHBHBHBHBHBHBHBHBHBHBHBHBHBHBH
BHBHQUBHBHBHqzqzBHQUBHBHBHBHBHBHBHBHBHBHBHBHBHNsSRkEKbNsBHBHBHBHBHBHBHBHBHBHBHBHBHBHBHBHBHBHBHBHBHBHBHBHBHBHBHBHBHBHBHBH
"}
