"a" = (/obj/structure/table/wood,/turf/open/floor/plating/f13/outside/desert,/area/survivalpod)
"b" = (/turf/open/indestructible/ground/outside/dirt{dir = 5; icon_state = "dirt"; tag = "icon-dirt (NORTHEAST)"},/area/survivalpod)
"c" = (/obj/structure/table/wood,/turf/open/indestructible/ground/outside/dirt{dir = 4; icon_state = "dirtcorner"; tag = "icon-dirtcorner (EAST)"},/area/survivalpod)
"e" = (/obj/structure/simple_door/tent,/turf/open/indestructible/ground/outside/dirt{dir = 4; icon_state = "dirt"},/area/survivalpod)
"f" = (/turf/open/indestructible/ground/outside/dirt{dir = 1; icon_state = "dirtcorner"},/area/survivalpod)
"g" = (/turf/open/floor/plating/f13/outside/desert,/area/f13/wasteland)
"h" = (/obj/item/bedsheet/cult,/obj/structure/bed,/turf/open/floor/f13/wood{icon_state = "housewood2"; tag = "icon-housewood2"},/area/survivalpod)
"i" = (/obj/structure/dresser,/turf/open/floor/f13/wood{icon_state = "housewood2"; tag = "icon-housewood2"},/area/survivalpod)
"k" = (/turf/closed/wall/f13/tentwall,/area/survivalpod)
"m" = (/turf/open/floor/plating/f13/outside/desert,/area/survivalpod)
"o" = (/obj/structure/simple_door/metal/barred,/obj/structure/curtain{color = "#845f58"},/turf/open/indestructible/ground/outside/dirt,/area/survivalpod)
"p" = (/turf/open/indestructible/ground/outside/dirt{dir = 4; icon_state = "dirtcorner"; tag = "icon-dirtcorner (EAST)"},/area/survivalpod)
"u" = (/obj/machinery/workbench,/turf/open/indestructible/ground/outside/dirt,/area/survivalpod)
"B" = (/obj/structure/table/wood,/obj/machinery/microwave,/turf/open/floor/f13/wood{icon_state = "housewood2"; tag = "icon-housewood2"},/area/survivalpod)
"C" = (/turf/open/indestructible/ground/outside/dirt,/area/survivalpod)
"D" = (/obj/structure/simple_door/tent,/turf/open/floor/f13/wood{icon_state = "housewood2"; tag = "icon-housewood2"},/area/survivalpod)
"G" = (/obj/machinery/autolathe/constructionlathe,/turf/open/indestructible/ground/outside/dirt,/area/survivalpod)
"H" = (/obj/structure/barricade/bars,/obj/structure/curtain{color = "#845f58"},/turf/open/indestructible/ground/outside/dirt,/area/survivalpod)
"I" = (/obj/structure/rack,/turf/open/indestructible/ground/outside/dirt,/area/survivalpod)
"K" = (/turf/open/floor/f13/wood{icon_state = "housewood2"; tag = "icon-housewood2"},/area/survivalpod)
"L" = (/turf/open/indestructible/ground/outside/dirt{dir = 9; icon_state = "dirt"; tag = "icon-dirt (NORTHWEST)"},/area/survivalpod)
"N" = (/obj/structure/table/wood,/obj/effect/spawner/lootdrop/f13/foodspawner,/obj/effect/spawner/lootdrop/f13/foodspawner,/obj/effect/spawner/lootdrop/f13/foodspawner,/turf/open/floor/f13/wood{icon_state = "housewood2"; tag = "icon-housewood2"},/area/survivalpod)
"U" = (/obj/structure/table/wood,/turf/open/indestructible/ground/outside/dirt{dir = 1; icon_state = "dirtcorner"; tag = "icon-dirtcorner (NORTH)"},/area/survivalpod)
"V" = (/turf/open/indestructible/ground/outside/dirt{dir = 1; icon_state = "dirt"},/area/survivalpod)
"X" = (/obj/structure/campfire/stove,/turf/open/floor/f13/wood{icon_state = "housewood2"; tag = "icon-housewood2"},/area/survivalpod)
"Z" = (/obj/structure/rack,/obj/item/stack/sheet/plasteel/twenty,/obj/item/stack/sheet/paperframes/twenty,/obj/item/stack/sheet/mineral/wood/twenty,/obj/item/stack/sheet/metal/twenty,/obj/item/stack/sheet/leather/twenty,/obj/item/stack/sheet/glass/ten,/turf/open/indestructible/ground/outside/dirt,/area/survivalpod)

(1,1,1) = {"
kkkkkkkkkk
kIZuGkNKhk
eCCCCDKKik
kkHokkBKXk
kICCIkkkkk
kLVVbkgggg
cfmmpUgggg
aaaaaagggg
"}
