"aa" = (/turf/open/indestructible/ground/outside/desert,/area/f13/wasteland)
"ab" = (/obj/structure/fence/corner{dir = 9; icon_state = "corner"},/turf/open/indestructible/ground/outside/desert,/area/f13/wasteland)
"ac" = (/obj/structure/fence{dir = 4; icon_state = "straight"; tag = "icon-metal_fence3"},/turf/open/indestructible/ground/outside/desert,/area/f13/wasteland)
"ad" = (/turf/closed/wall/f13/wood/house,/area/f13/village)
"ae" = (/obj/structure/window/fulltile/house{icon_state = "housewindowbrokenvertical"; tag = "icon-housewindowbrokenvertical (NORTHEAST)"},/obj/structure/barricade/wooden/planks/pregame,/turf/open/floor/f13/wood,/area/f13/village)
"af" = (/obj/structure/fence{dir = 8; icon_state = "straight"},/turf/open/indestructible/ground/outside/desert,/area/f13/wasteland)
"ag" = (/obj/structure/fence,/turf/open/indestructible/ground/outside/desert,/area/f13/wasteland)
"ah" = (/obj/structure/fermenting_barrel,/turf/open/indestructible/ground/outside/dirt{icon_state = "dirtcorner"},/area/f13/wasteland)
"ai" = (/turf/open/indestructible/ground/outside/dirt{icon_state = "dirt"; tag = "icon-dirt"},/area/f13/wasteland)
"aj" = (/mob/living/simple_animal/cow/brahmin,/turf/open/indestructible/ground/outside/dirt{icon_state = "dirt"},/area/f13/wasteland)
"ak" = (/turf/open/indestructible/ground/outside/dirt{icon_state = "dirt"},/area/f13/wasteland)
"al" = (/turf/open/indestructible/ground/outside/dirt{dir = 8; icon_state = "dirtcorner"},/area/f13/wasteland)
"am" = (/obj/structure/simple_door/house,/turf/open/floor/f13/wood,/area/f13/village)
"an" = (/turf/open/floor/f13/wood,/area/f13/village)
"ao" = (/obj/machinery/light/small{dir = 1},/turf/open/floor/f13/wood,/area/f13/village)
"ap" = (/obj/structure/sink/kitchen{pixel_y = 28},/turf/open/floor/f13/wood,/area/f13/village)
"aq" = (/obj/machinery/light/small{dir = 1},/obj/structure/closet/fridge,/obj/item/reagent_containers/food/drinks/drinkingglass/shotglass,/obj/item/reagent_containers/food/drinks/drinkingglass/shotglass,/obj/item/reagent_containers/food/drinks/drinkingglass/shotglass,/obj/item/reagent_containers/food/drinks/drinkingglass/shotglass,/obj/item/reagent_containers/food/drinks/drinkingglass/shotglass,/obj/item/reagent_containers/food/drinks/drinkingglass/shotglass,/obj/effect/spawner/lootdrop/f13/alcoholspawner,/obj/effect/spawner/lootdrop/f13/alcoholspawner,/turf/open/floor/f13/wood,/area/f13/village)
"ar" = (/obj/structure/closet/fridge,/obj/item/reagent_containers/food/condiment/yeast,/obj/item/reagent_containers/food/condiment/flour,/obj/effect/spawner/lootdrop/f13/foodspawner,/obj/effect/spawner/lootdrop/f13/foodspawner,/turf/open/floor/f13/wood,/area/f13/village)
"as" = (/turf/closed/wall/f13/wood/interior,/area/f13/village)
"at" = (/obj/structure/chair/wood/fancy{dir = 4},/turf/open/floor/f13/wood,/area/f13/village)
"au" = (/obj/machinery/light/small{dir = 1},/obj/effect/spawner/lootdrop/f13/alcoholspawner,/obj/structure/table/wood/fancy,/obj/item/reagent_containers/food/drinks/drinkingglass{pixel_y = 10},/obj/item/reagent_containers/food/drinks/drinkingglass{pixel_y = 10},/obj/effect/spawner/lootdrop/three_course_meal,/turf/open/floor/f13/wood,/area/f13/village)
"av" = (/obj/structure/chair/wood/fancy{dir = 8},/turf/open/floor/f13/wood,/area/f13/village)
"aw" = (/obj/machinery/light/small{dir = 1},/obj/structure/closet/cabinet,/obj/effect/spawner/lootdrop/clothing_middle,/obj/item/clothing/shoes/singery,/obj/item/clothing/under/singery,/obj/item/clothing/under/f13/bartenderalt,/obj/item/clothing/shoes/f13/fancy,/obj/item/reagent_containers/food/drinks/flask,/obj/item/toy/clockwork_watch,/obj/effect/spawner/lootdrop/minor/kittyears_or_rabbitears,/obj/effect/spawner/lootdrop/minor/bowler_or_that,/turf/open/floor/f13/wood,/area/f13/village)
"ax" = (/obj/structure/bed,/obj/item/bedsheet{icon_state = "sheethos"; tag = "icon-sheethos"},/turf/open/floor/f13/wood,/area/f13/village)
"ay" = (/turf/open/indestructible/ground/outside/dirt{icon_state = "dirtcorner"},/area/f13/farm)
"az" = (/turf/open/indestructible/ground/outside/dirt{icon_state = "dirt"},/area/f13/farm)
"aA" = (/turf/open/indestructible/ground/outside/dirt{dir = 8; icon_state = "dirtcorner"},/area/f13/farm)
"aB" = (/turf/open/indestructible/ground/outside/dirt{dir = 4; icon_state = "dirt"; tag = "icon-dirt (EAST)"},/area/f13/wasteland)
"aC" = (/turf/open/indestructible/ground/outside/dirt,/area/f13/wasteland)
"aD" = (/mob/living/simple_animal/cow/brahmin,/turf/open/indestructible/ground/outside/dirt,/area/f13/wasteland)
"aE" = (/turf/open/indestructible/ground/outside/dirt{dir = 8; icon_state = "dirt"},/area/f13/wasteland)
"aF" = (/turf/open/floor/f13/wood{icon_state = "housewood4-broken"; tag = "icon-housewood4-broken"},/area/f13/village)
"aG" = (/turf/open/floor/f13/wood{icon_state = "housewood2-broken"; tag = "icon-housewood2-broken"},/area/f13/village)
"aH" = (/obj/structure/sink/well,/turf/open/indestructible/ground/outside/dirt{dir = 4; icon_state = "dirt"},/area/f13/farm)
"aI" = (/turf/open/indestructible/ground/outside/dirt,/area/f13/farm)
"aJ" = (/turf/open/indestructible/ground/outside/dirt{dir = 8; icon_state = "dirt"},/area/f13/farm)
"aK" = (/turf/open/indestructible/ground/outside/dirt{icon_state = "dirtcorner"; tag = "icon-dirtcorner"},/area/f13/wasteland)
"aL" = (/turf/open/indestructible/ground/outside/dirt{dir = 8; icon_state = "dirtcorner"; tag = "icon-dirtcorner (WEST)"},/area/f13/wasteland)
"aM" = (/turf/open/indestructible/ground/outside/dirt{dir = 9; icon_state = "dirt"; tag = "icon-dirt (NORTHWEST)"},/area/f13/wasteland)
"aN" = (/mob/living/simple_animal/cow/brahmin,/turf/open/indestructible/ground/outside/dirt{dir = 1; icon_state = "dirt"},/area/f13/wasteland)
"aO" = (/turf/open/indestructible/ground/outside/dirt{dir = 1; icon_state = "dirtcorner"},/area/f13/wasteland)
"aP" = (/obj/structure/table/wood,/obj/machinery/reagentgrinder,/turf/open/floor/f13/wood,/area/f13/village)
"aQ" = (/obj/machinery/microwave/stove,/turf/open/floor/f13/wood,/area/f13/village)
"aR" = (/obj/structure/table/wood,/obj/item/kitchen/knife,/turf/open/floor/f13/wood,/area/f13/village)
"aS" = (/obj/structure/table/wood,/obj/item/kitchen/rollingpin,/turf/open/floor/f13/wood,/area/f13/village)
"aT" = (/obj/structure/kitchenspike,/turf/open/floor/f13/wood,/area/f13/village)
"aU" = (/obj/structure/bookcase/random/adult,/turf/open/floor/f13/wood,/area/f13/village)
"aV" = (/obj/machinery/light/small,/obj/structure/table/wood/settler,/obj/item/paper_bin,/obj/item/pen,/turf/open/floor/f13/wood,/area/f13/village)
"aW" = (/obj/structure/chair/wood{dir = 8},/turf/open/floor/f13/wood,/area/f13/village)
"aX" = (/turf/open/floor/f13/wood{icon_state = "housewood3-broken"; tag = "icon-housewood3-broken"},/area/f13/village)
"aY" = (/obj/structure/table/wood/fancy,/obj/item/restraints/handcuffs,/obj/item/melee/chainofcommand/tailwhip/kitty,/obj/item/dildo,/turf/open/floor/f13/wood,/area/f13/village)
"aZ" = (/turf/open/indestructible/ground/outside/dirt{dir = 4; icon_state = "dirt"},/area/f13/farm)
"ba" = (/obj/structure/toilet,/obj/machinery/light/small{dir = 1},/obj/item/reagent_containers/food/snacks/f13/steak,/obj/item/twohanded/sledgehammer,/obj/effect/decal/remains/human,/turf/open/floor/f13/wood,/area/f13/village)
"bb" = (/turf/open/indestructible/ground/outside/dirt{dir = 4; icon_state = "dirtcorner"; tag = "icon-dirtcorner (EAST)"},/area/f13/wasteland)
"bc" = (/turf/open/indestructible/ground/outside/dirt{dir = 1; icon_state = "dirtcorner"; tag = "icon-dirtcorner (NORTH)"},/area/f13/wasteland)
"bd" = (/turf/open/indestructible/ground/outside/dirt{dir = 8; icon_state = "dirt"; tag = "icon-dirt (WEST)"},/area/f13/wasteland)
"be" = (/obj/structure/simple_door/room,/turf/open/floor/f13/wood,/area/f13/village)
"bf" = (/obj/structure/fence/corner{dir = 4; icon_state = "end"},/turf/open/indestructible/ground/outside/desert,/area/f13/wasteland)
"bg" = (/obj/structure/fence{dir = 8; icon_state = "straight"},/turf/open/indestructible/ground/outside/dirt{dir = 4; icon_state = "dirt"},/area/f13/wasteland)
"bh" = (/obj/structure/simple_door/metal/fence,/turf/open/indestructible/ground/outside/dirt,/area/f13/wasteland)
"bi" = (/obj/structure/fence{dir = 8; icon_state = "straight"},/turf/open/indestructible/ground/outside/dirt{dir = 8; icon_state = "dirt"; tag = "icon-dirt (WEST)"},/area/f13/wasteland)
"bj" = (/obj/machinery/light/small{dir = 1},/obj/effect/decal/cleanable/cobweb,/turf/open/floor/f13/wood,/area/f13/village)
"bk" = (/obj/structure/bed,/obj/machinery/light/small{dir = 1},/turf/open/floor/f13/wood,/area/f13/village)
"bl" = (/obj/effect/decal/cleanable/blood,/obj/effect/decal/cleanable/blood/gibs/body,/obj/effect/decal/cleanable/blood/gibs{icon_state = "gibup1"; tag = "icon-gibup1"},/obj/effect/decal/cleanable/cobweb,/turf/open/floor/f13/wood,/area/f13/village)
"bm" = (/mob/living/simple_animal/hostile/ghoul,/turf/open/floor/f13/wood,/area/f13/village)
"bn" = (/obj/structure/rack,/obj/item/seeds/poppy/broc,/obj/item/seeds/poppy/broc,/obj/item/seeds/xander,/obj/machinery/light/small{dir = 1},/obj/item/seeds/xander,/obj/item/seeds/wheat,/obj/item/seeds/wheat,/obj/item/seeds/tomato,/obj/item/seeds/tomato,/obj/item/seeds/sugarcane,/obj/item/seeds/sugarcane,/turf/open/floor/f13/wood,/area/f13/village)
"bo" = (/obj/structure/rack,/obj/item/shovel/spade,/obj/item/shovel,/obj/item/reagent_containers/glass/bucket,/obj/item/cultivator,/obj/item/storage/bag/plants,/obj/item/scythe,/turf/open/floor/f13/wood,/area/f13/village)
"bp" = (/turf/open/indestructible/ground/outside/dirt{dir = 10; icon_state = "dirt"},/area/f13/farm)
"bq" = (/turf/open/indestructible/ground/outside/dirt{dir = 4; icon_state = "dirt"},/area/f13/wasteland)
"br" = (/obj/effect/decal/cleanable/blood/tracks,/turf/open/floor/f13/wood,/area/f13/village)
"bs" = (/mob/living/simple_animal/hostile/ghoul,/turf/open/floor/f13/wood{icon_state = "housewood3-broken"; tag = "icon-housewood3-broken"},/area/f13/village)
"bt" = (/obj/structure/chair/wood,/turf/open/floor/f13/wood,/area/f13/village)
"bu" = (/obj/effect/decal/cleanable/blood/gibs/body,/turf/open/floor/f13/wood,/area/f13/village)
"bv" = (/obj/structure/window/fulltile/house{dir = 2; icon_state = "housewindow"; tag = "icon-housewindow"},/obj/structure/barricade/wooden/planks/pregame,/turf/open/floor/f13/wood,/area/f13/village)
"bw" = (/obj/machinery/hydroponics/soil,/turf/open/indestructible/ground/outside/dirt,/area/f13/farm)
"bx" = (/obj/structure/car,/turf/open/indestructible/ground/outside/desert,/area/f13/wasteland)
"by" = (/turf/open/space/basic,/area/f13/village)
"bz" = (/obj/structure/bed,/obj/item/bedsheet{icon_state = "sheetgrey"; tag = "icon-sheetgrey"},/turf/open/floor/f13/wood,/area/f13/village)
"bA" = (/obj/effect/decal/cleanable/blood/tracks,/mob/living/simple_animal/hostile/ghoul,/turf/open/floor/f13/wood,/area/f13/village)
"bB" = (/obj/structure/table/wood/settler,/turf/open/floor/f13/wood,/area/f13/village)
"bC" = (/mob/living/simple_animal/hostile/ghoul/reaver,/turf/open/floor/f13/wood,/area/f13/village)
"bD" = (/obj/structure/table/wood/settler,/obj/effect/spawner/lootdrop/f13/weapon/gun/random,/turf/open/floor/f13/wood,/area/f13/village)
"bE" = (/turf/open/indestructible/ground/outside/dirt{dir = 6; icon_state = "dirt"; tag = "icon-dirt (SOUTHEAST)"},/area/f13/wasteland)
"bF" = (/turf/open/indestructible/ground/outside/dirt{dir = 10; icon_state = "dirt"; tag = "icon-dirt (SOUTHWEST)"},/area/f13/wasteland)
"bG" = (/obj/effect/decal/cleanable/blood/splatter,/turf/open/floor/f13/wood,/area/f13/village)
"bH" = (/obj/structure/chair/wood{dir = 1},/turf/open/floor/f13/wood,/area/f13/village)
"bI" = (/obj/structure/simple_door/room,/obj/structure/barricade/wooden/planks,/turf/open/floor/f13/wood,/area/f13/village)
"bJ" = (/obj/machinery/light/small{dir = 1},/turf/open/floor/f13/wood{icon_state = "housewood3-broken"; tag = "icon-housewood3-broken"},/area/f13/village)
"bK" = (/obj/effect/decal/cleanable/blood,/turf/open/floor/f13/wood{icon_state = "housewood3-broken"; tag = "icon-housewood3-broken"},/area/f13/village)
"bL" = (/turf/open/indestructible/ground/outside/dirt{dir = 1; icon_state = "dirt"},/area/f13/wasteland)
"bM" = (/turf/open/indestructible/ground/outside/dirt{dir = 1; icon_state = "dirt"; tag = "icon-dirt (NORTH)"},/area/f13/wasteland)
"bN" = (/obj/effect/decal/cleanable/blood/gibs/limb,/turf/open/floor/f13/wood,/area/f13/village)
"bO" = (/obj/machinery/light/small,/turf/open/floor/f13/wood,/area/f13/village)
"bP" = (/obj/item/reagent_containers/glass/bucket,/obj/machinery/hydroponics/soil,/turf/open/indestructible/ground/outside/dirt,/area/f13/farm)
"bQ" = (/obj/structure/car/rubbish3,/turf/open/indestructible/ground/outside/desert,/area/f13/wasteland)
"bR" = (/obj/structure/bed/mattress,/turf/open/floor/f13/wood,/area/f13/village)
"bS" = (/obj/structure/bed/mattress,/obj/effect/decal/cleanable/cobweb/cobweb2,/turf/open/floor/f13/wood,/area/f13/village)
"bT" = (/obj/structure/rack,/obj/effect/spawner/lootdrop/f13/armor/costumes,/turf/open/floor/f13/wood,/area/f13/village)
"bU" = (/obj/machinery/light/small{dir = 1},/obj/structure/rack,/obj/effect/spawner/lootdrop/trash,/turf/open/floor/f13/wood,/area/f13/village)
"bV" = (/obj/structure/rack,/obj/effect/spawner/lootdrop/f13/cash_random_low,/turf/open/floor/f13/wood,/area/f13/village)
"bW" = (/obj/machinery/light/small{dir = 1},/obj/structure/rack,/obj/effect/spawner/lootdrop/f13/weapon/gun/random,/turf/open/floor/f13/wood,/area/f13/village)
"bX" = (/obj/structure/rack,/obj/effect/spawner/lootdrop/f13/armor/random,/turf/open/floor/f13/wood,/area/f13/village)
"bY" = (/obj/item/seeds/poppy/broc,/obj/machinery/hydroponics/soil,/turf/open/indestructible/ground/outside/dirt,/area/f13/farm)
"bZ" = (/mob/living/simple_animal/hostile/ghoul,/turf/open/floor/f13/wood{icon_state = "housewood4-broken"; tag = "icon-housewood4-broken"},/area/f13/village)
"ca" = (/obj/structure/fermenting_barrel,/turf/open/indestructible/ground/outside/dirt{dir = 4; icon_state = "dirtcorner"},/area/f13/farm)
"cb" = (/turf/open/indestructible/ground/outside/dirt{dir = 1; icon_state = "dirt"},/area/f13/farm)
"cc" = (/turf/open/indestructible/ground/outside/dirt{dir = 1; icon_state = "dirtcorner"},/area/f13/farm)
"cd" = (/obj/structure/rack,/obj/effect/spawner/lootdrop/f13/medical/wasteland/meds,/turf/open/floor/f13/wood,/area/f13/village)
"ce" = (/obj/structure/rack,/obj/effect/spawner/lootdrop/f13/medical/wasteland/meds,/turf/open/floor/f13/wood{icon_state = "housewood4-broken"; tag = "icon-housewood4-broken"},/area/f13/village)

(1,1,1) = {"
aaaaaaaaaaaaaaaaaaaaaaaaaaaaaaaaaaaaaaaaaaaaaaaaaaaaaaaaaaaa
aaaaabacacacacacadadadaeadadadadadadadadadadadafafafafafafaf
aaaaagahaiajakalamanaoanapaqarasatauavanawaxadayazaAaaaaaaaa
aaaaagaBaCaCaDaEadanaFananaGanasanaGananananadaHaIaJadadadaa
aKaLagaBaCaMaNaOadaPaQaRaSanaTasanaUaVaWaXaYadaZaIaJadbaadaa
bbbcagaBaCbdadadadasasasasbeasasbeasasasasasadaZaIaJadamadaa
aaaabfbgbhbiadbjaWanbkasblananbmanasananbnboadaZaIbpazazazaA
aaaaaabqaCbdaeananananbebrbsbtanbuasbtanananbvaZbwbwaIbwbwaJ
aabxaabqaCbdadananbybzasbAanbBbCanasbDanaFanbvaZaIaIaIaIaIaJ
aiaiaibEaCbFadasasasasasanbGbBaWbmasbHaXaGbmadaZbwbwaIbwbwaJ
aCaCaCaCaCaCbIananbJanananbmanbKanbeananananamaZaIaIaIaIaIaJ
bLbLbLbLbLbMadanaGanaXasbNananananasbOanananadaZbwbwaIbPbwaJ
bQaaaaaaaaaaadadadasasasbeasasasasasasbeasasadaZaIaIaIaIaIaJ
aaaaaaaaaaaaaaaaadbRanbRanaobSasbTbUbVanbWbXadaZbwbwaIbYbwaJ
aaaaaaaaaaaaaaaaadanbZaGaXananasanaGanbmananbvcacbcbcbcbcbcc
aaaaaaaaaaaaaaaaadbRaXbRbZanbRascdbXcebTbTbXadafafafafafafaf
aaaaaaaaaaaaaaaaadadadadaeadadadaeadadaeadadadaaaaaaaaaaaaaa
"}
