//MAP CONVERTED BY dmm2tgm.py THIS HEADER COMMENT PREVENTS RECONVERSION, DO NOT REMOVE
"a" = (
/obj/structure/table/wood,
/turf/open/floor/plating/f13/outside/desert,
/area/survivalpod)
"c" = (
/turf/closed/wall/f13/tentwall,
/area/survivalpod)
"e" = (
/turf/open/indestructible/ground/outside/dirt{
	dir = 4;
	icon_state = "dirtcorner"
	},
/area/survivalpod)
"f" = (
/obj/structure/table/wood,
/obj/effect/spawner/lootdrop/f13/foodspawner,
/obj/effect/spawner/lootdrop/f13/foodspawner,
/obj/effect/spawner/lootdrop/f13/foodspawner,
/turf/open/floor/f13/wood{
	icon_state = "housewood2"
	},
/area/survivalpod)
"g" = (
/turf/open/floor/f13/wood{
	icon_state = "housewood2"
	},
/area/survivalpod)
"l" = (
/turf/open/floor/plating/f13/outside/desert,
/area/survivalpod)
"r" = (
/turf/open/indestructible/ground/outside/dirt{
	dir = 1;
	icon_state = "dirt"
	},
/area/survivalpod)
"s" = (
/obj/structure/campfire/stove,
/turf/open/floor/f13/wood{
	icon_state = "housewood2"
	},
/area/survivalpod)
"x" = (
/obj/structure/rack,
/turf/open/indestructible/ground/outside/dirt,
/area/survivalpod)
"y" = (
/obj/structure/table/wood,
/turf/open/indestructible/ground/outside/dirt{
	dir = 4;
	icon_state = "dirtcorner"
	},
/area/survivalpod)
"z" = (
/obj/structure/table/wood,
/obj/machinery/microwave,
/turf/open/floor/f13/wood{
	icon_state = "housewood2"
	},
/area/survivalpod)
"D" = (
/turf/open/indestructible/ground/outside/dirt{
	dir = 1;
	icon_state = "dirtcorner"
	},
/area/survivalpod)
"E" = (
/obj/structure/table/wood,
/turf/open/indestructible/ground/outside/dirt{
	dir = 1;
	icon_state = "dirtcorner"
	},
/area/survivalpod)
"G" = (
/obj/structure/barricade/bars,
/obj/structure/curtain{
	color = "#845f58"
	},
/turf/open/indestructible/ground/outside/dirt,
/area/survivalpod)
"I" = (
/turf/open/indestructible/ground/outside/dirt{
	dir = 9;
	icon_state = "dirt"
	},
/area/survivalpod)
"J" = (
/obj/structure/simple_door/tent,
/turf/open/floor/f13/wood{
	icon_state = "housewood2"
	},
/area/survivalpod)
"L" = (
/obj/structure/rack,
/obj/item/stack/sheet/plasteel/twenty,
/obj/item/stack/sheet/paperframes/twenty,
/obj/item/stack/sheet/mineral/wood/twenty,
/obj/item/stack/sheet/metal/twenty,
/obj/item/stack/sheet/leather/twenty,
/obj/item/stack/sheet/glass/ten,
/turf/open/indestructible/ground/outside/dirt,
/area/survivalpod)
"M" = (
/turf/open/indestructible/ground/outside/dirt{
	dir = 5;
	icon_state = "dirt"
	},
/area/survivalpod)
"N" = (
/obj/structure/simple_door/metal/barred,
/obj/structure/curtain{
	color = "#845f58"
	},
/turf/open/indestructible/ground/outside/dirt,
/area/survivalpod)
"O" = (
/obj/structure/dresser,
/turf/open/floor/f13/wood{
	icon_state = "housewood2"
	},
/area/survivalpod)
"P" = (
/obj/machinery/workbench,
/turf/open/indestructible/ground/outside/dirt,
/area/survivalpod)
"Q" = (
/turf/open/floor/plating/f13/outside/desert,
/area/f13/wasteland)
"R" = (
/obj/item/bedsheet/cult,
/obj/structure/bed,
/turf/open/floor/f13/wood{
	icon_state = "housewood2"
	},
/area/survivalpod)
"S" = (
/obj/structure/simple_door/tent,
/turf/open/indestructible/ground/outside/dirt{
	dir = 4;
	icon_state = "dirt"
	},
/area/survivalpod)
"V" = (
/turf/open/indestructible/ground/outside/dirt,
/area/survivalpod)
"X" = (
/obj/machinery/autolathe/constructionlathe,
/turf/open/indestructible/ground/outside/dirt,
/area/survivalpod)

(1,1,1) = {"
c
c
S
c
c
c
y
a
"}
(2,1,1) = {"
c
x
V
c
x
I
D
a
"}
(3,1,1) = {"
c
L
V
G
V
r
l
a
"}
(4,1,1) = {"
c
P
V
N
V
r
l
a
"}
(5,1,1) = {"
c
X
V
c
x
M
e
a
"}
(6,1,1) = {"
c
c
J
c
c
c
E
a
"}
(7,1,1) = {"
c
f
g
z
c
Q
Q
Q
"}
(8,1,1) = {"
c
g
g
g
c
Q
Q
Q
"}
(9,1,1) = {"
c
R
O
s
c
Q
Q
Q
"}
(10,1,1) = {"
c
c
c
c
c
Q
Q
Q
"}
