//MAP CONVERTED BY dmm2tgm.py THIS HEADER COMMENT PREVENTS RECONVERSION, DO NOT REMOVE
"a" = (
/turf/closed/wall/f13/tentwall,
/area/survivalpod)
"b" = (
/obj/structure/table,
/obj/machinery/chem_dispenser/drinks{
	dir = 4
	},
/turf/open/indestructible/ground/outside/dirt{
	dir = 8;
	icon_state = "dirt"
	},
/area/survivalpod)
"c" = (
/obj/structure/table,
/turf/open/floor/f13/wood,
/area/survivalpod)
"d" = (
/obj/structure/chair,
/turf/open/indestructible/ground/outside/dirt{
	dir = 1;
	icon_state = "dirt"
	},
/area/survivalpod)
"e" = (
/obj/structure/table,
/turf/open/floor/plating/f13/outside/desert,
/area/survivalpod)
"g" = (
/obj/structure/campfire/stove,
/turf/open/indestructible/ground/outside/dirt,
/area/survivalpod)
"h" = (
/obj/structure/closet,
/turf/open/floor/f13/wood,
/area/survivalpod)
"m" = (
/obj/structure/dresser,
/turf/open/floor/f13/wood,
/area/survivalpod)
"n" = (
/obj/structure/closet/fridge/standard{
	anchored = 1;
	storage_capacity = 100
	},
/obj/item/reagent_containers/food/condiment/flour,
/obj/item/reagent_containers/food/condiment/flour,
/obj/item/reagent_containers/food/condiment/flour,
/obj/item/reagent_containers/food/condiment/flour,
/obj/item/reagent_containers/food/condiment/flour,
/obj/item/reagent_containers/food/condiment/rice,
/obj/item/reagent_containers/food/condiment/rice,
/obj/item/reagent_containers/food/condiment/rice,
/obj/item/reagent_containers/food/condiment/rice,
/obj/item/reagent_containers/food/condiment/rice,
/obj/item/reagent_containers/food/condiment/soysauce,
/obj/item/reagent_containers/food/condiment/soysauce,
/obj/item/reagent_containers/food/condiment/soysauce,
/obj/item/reagent_containers/food/condiment/milk,
/obj/item/reagent_containers/food/condiment/milk,
/obj/item/reagent_containers/food/condiment/milk,
/obj/item/reagent_containers/food/condiment/milk,
/obj/item/reagent_containers/food/condiment/milk,
/obj/item/reagent_containers/food/condiment/saltshaker,
/obj/item/reagent_containers/food/condiment/peppermill,
/obj/item/reagent_containers/food/snacks/grown/tomato,
/obj/item/reagent_containers/food/snacks/grown/tomato,
/obj/item/reagent_containers/food/snacks/grown/tomato,
/obj/item/reagent_containers/food/snacks/grown/tomato,
/obj/item/reagent_containers/food/snacks/grown/tomato,
/obj/item/reagent_containers/food/snacks/grown/carrot,
/obj/item/reagent_containers/food/snacks/grown/carrot,
/obj/item/reagent_containers/food/snacks/grown/potato,
/obj/item/reagent_containers/food/snacks/grown/potato,
/obj/item/reagent_containers/food/snacks/grown/potato,
/obj/item/reagent_containers/food/condiment/peppermill,
/obj/item/reagent_containers/food/condiment/saltshaker,
/obj/item/reagent_containers/food/condiment/flour,
/obj/item/reagent_containers/food/condiment/flour,
/obj/item/reagent_containers/food/condiment/flour,
/obj/item/reagent_containers/food/condiment/flour,
/obj/item/reagent_containers/food/condiment/flour,
/obj/item/reagent_containers/food/condiment/flour,
/obj/item/reagent_containers/food/condiment/rice,
/obj/item/reagent_containers/food/condiment/rice,
/obj/item/reagent_containers/food/condiment/rice,
/obj/item/reagent_containers/food/condiment/soymilk,
/obj/item/reagent_containers/food/condiment/soymilk,
/obj/item/reagent_containers/food/condiment/soymilk,
/obj/item/reagent_containers/food/condiment/soymilk,
/obj/item/reagent_containers/food/condiment/soymilk,
/obj/item/reagent_containers/food/condiment/soymilk,
/obj/item/reagent_containers/food/condiment/soymilk,
/obj/item/reagent_containers/food/condiment/milk,
/obj/item/reagent_containers/food/condiment/milk,
/obj/item/reagent_containers/food/condiment/milk,
/obj/item/reagent_containers/food/condiment/milk,
/obj/item/reagent_containers/food/condiment/milk,
/obj/item/reagent_containers/food/condiment/milk,
/obj/item/reagent_containers/food/condiment/milk,
/obj/item/reagent_containers/food/condiment/milk,
/obj/item/reagent_containers/food/condiment/flour,
/obj/item/reagent_containers/food/condiment/flour,
/obj/item/reagent_containers/food/condiment/flour,
/obj/item/reagent_containers/food/condiment/flour,
/turf/open/indestructible/ground/outside/dirt,
/area/survivalpod)
"q" = (
/obj/structure/table,
/obj/machinery/reagentgrinder{
	pixel_y = 14
	},
/turf/open/indestructible/ground/outside/dirt,
/area/survivalpod)
"r" = (
/obj/structure/table,
/obj/item/storage/box/drinkingglasses,
/obj/item/storage/box/drinkingglasses,
/turf/open/indestructible/ground/outside/dirt{
	dir = 9;
	icon_state = "dirt"
	},
/area/survivalpod)
"s" = (
/obj/structure/sink{
	dir = 8;
	icon_state = "sink";
	pixel_x = -13;
	pixel_y = 0
	},
/turf/open/indestructible/ground/outside/dirt,
/area/survivalpod)
"t" = (
/obj/structure/simple_door/tent,
/turf/open/indestructible/ground/outside/dirt,
/area/survivalpod)
"u" = (
/obj/machinery/vending/dinnerware,
/turf/open/indestructible/ground/outside/dirt,
/area/survivalpod)
"w" = (
/turf/open/indestructible/ground/outside/dirt,
/area/survivalpod)
"x" = (
/obj/structure/table,
/obj/item/storage/box/ingredients/delights,
/obj/item/storage/box/ingredients/wildcard,
/obj/item/storage/box/ingredients/wildcard,
/obj/item/storage/box/ingredients/wildcard,
/obj/item/storage/box/ingredients/wildcard,
/obj/item/storage/box/ingredients/wildcard,
/turf/open/indestructible/ground/outside/dirt,
/area/survivalpod)
"y" = (
/turf/open/indestructible/ground/outside/dirt{
	dir = 1;
	icon_state = "dirt"
	},
/area/survivalpod)
"z" = (
/obj/structure/table,
/obj/item/reagent_containers/food/condiment/yeast,
/obj/item/reagent_containers/food/condiment/ketchup,
/obj/item/reagent_containers/food/condiment/ketchup,
/turf/open/indestructible/ground/outside/dirt,
/area/survivalpod)
"B" = (
/obj/structure/chair{
	dir = 1;
	icon_state = "f13chair2"
	},
/turf/open/indestructible/ground/outside/dirt{
	icon_state = "dirt"
	},
/area/survivalpod)
"C" = (
/obj/structure/table,
/obj/machinery/processor/chopping_block,
/turf/open/indestructible/ground/outside/dirt,
/area/survivalpod)
"D" = (
/obj/structure/table,
/obj/item/storage/box/ingredients/grains,
/obj/item/kitchen/knife,
/obj/item/reagent_containers/food/snacks/store/cheesewheel,
/obj/item/reagent_containers/food/snacks/store/cheesewheel,
/obj/item/reagent_containers/food/snacks/store/cheesewheel,
/obj/item/kitchen/rollingpin,
/obj/item/reagent_containers/food/snacks/store/cheesewheel,
/obj/item/reagent_containers/food/snacks/store/cheesewheel,
/obj/item/reagent_containers/food/snacks/store/cheesewheel,
/obj/item/reagent_containers/food/snacks/store/cheesewheel,
/turf/open/indestructible/ground/outside/dirt,
/area/survivalpod)
"E" = (
/turf/open/floor/plating/f13/outside/desert,
/area/survivalpod)
"H" = (
/obj/structure/simple_door/tent,
/turf/open/floor/f13/wood,
/area/survivalpod)
"I" = (
/obj/structure/chair{
	dir = 1;
	icon_state = "f13chair2"
	},
/turf/open/floor/plating/f13/outside/desert,
/area/survivalpod)
"J" = (
/obj/structure/table,
/obj/item/storage/bag/plants,
/obj/item/storage/bag/plants,
/obj/item/reagent_containers/glass/beaker/large,
/obj/item/reagent_containers/glass/beaker/large,
/obj/item/reagent_containers/glass/beaker/large,
/turf/open/indestructible/ground/outside/dirt{
	dir = 10;
	icon_state = "dirt"
	},
/area/survivalpod)
"O" = (
/obj/item/candle/tribal_torch,
/turf/open/floor/plating/f13/outside/desert,
/area/survivalpod)
"P" = (
/obj/structure/bed/mattress,
/turf/open/floor/f13/wood,
/area/survivalpod)
"Q" = (
/obj/structure/closet/fridge/standard{
	anchored = 1;
	storage_capacity = 100
	},
/obj/item/reagent_containers/food/snacks/meat/slab,
/obj/item/reagent_containers/food/snacks/meat/slab,
/obj/item/reagent_containers/food/snacks/meat/slab,
/obj/item/reagent_containers/food/snacks/meat/slab,
/obj/item/reagent_containers/food/snacks/meat/slab,
/obj/item/reagent_containers/food/snacks/meat/slab,
/obj/item/reagent_containers/food/snacks/meat/slab,
/obj/item/reagent_containers/food/snacks/meat/slab,
/obj/item/reagent_containers/food/snacks/meat/slab,
/obj/item/reagent_containers/food/snacks/meat/slab,
/obj/item/reagent_containers/food/snacks/meat/slab,
/obj/item/reagent_containers/food/snacks/meat/slab,
/obj/item/reagent_containers/food/snacks/meat/slab,
/obj/item/reagent_containers/food/snacks/meat/slab,
/obj/item/reagent_containers/food/snacks/meat/slab,
/obj/item/reagent_containers/food/snacks/meat/slab,
/obj/item/reagent_containers/food/snacks/meat/slab,
/obj/item/reagent_containers/food/snacks/meat/slab,
/obj/item/reagent_containers/food/snacks/meat/slab,
/obj/item/reagent_containers/food/snacks/meat/slab,
/obj/item/reagent_containers/food/snacks/grown/corn,
/obj/item/reagent_containers/food/snacks/grown/corn,
/obj/item/reagent_containers/food/snacks/grown/corn,
/obj/item/reagent_containers/food/snacks/grown/grapes,
/obj/item/reagent_containers/food/snacks/grown/grapes,
/obj/item/reagent_containers/food/snacks/grown/grapes,
/obj/item/reagent_containers/food/snacks/grown/grapes/green,
/obj/item/reagent_containers/food/snacks/grown/grapes/green,
/obj/item/reagent_containers/food/snacks/grown/grapes/green,
/obj/item/reagent_containers/food/snacks/grown/corn,
/obj/item/reagent_containers/food/snacks/grown/corn,
/obj/item/reagent_containers/food/snacks/grown/corn,
/obj/item/reagent_containers/food/snacks/grown/corn,
/obj/item/reagent_containers/food/snacks/grown/corn,
/obj/item/reagent_containers/food/snacks/grown/corn,
/obj/item/reagent_containers/food/snacks/grown/corn,
/obj/item/reagent_containers/food/snacks/grown/corn,
/obj/item/reagent_containers/food/snacks/grown/corn,
/obj/item/reagent_containers/food/snacks/grown/corn,
/obj/item/reagent_containers/food/snacks/meat/slab,
/obj/item/reagent_containers/food/snacks/meat/slab,
/obj/item/reagent_containers/food/snacks/meat/slab,
/obj/item/reagent_containers/food/snacks/meat/slab,
/obj/item/reagent_containers/food/snacks/meat/slab,
/obj/item/reagent_containers/food/snacks/meat/slab,
/obj/item/reagent_containers/food/snacks/meat/slab,
/obj/item/reagent_containers/food/snacks/meat/slab,
/obj/item/reagent_containers/food/snacks/meat/slab,
/obj/item/reagent_containers/food/snacks/meat/slab,
/obj/item/reagent_containers/food/snacks/meat/slab,
/obj/item/reagent_containers/food/snacks/meat/slab,
/obj/item/reagent_containers/food/snacks/meat/slab,
/obj/item/reagent_containers/food/snacks/meat/slab,
/obj/item/reagent_containers/food/snacks/meat/slab,
/obj/item/reagent_containers/food/snacks/meat/slab,
/obj/item/reagent_containers/food/snacks/grown/corn,
/obj/item/reagent_containers/food/snacks/grown/corn,
/obj/item/reagent_containers/food/snacks/grown/corn,
/obj/item/reagent_containers/food/snacks/grown/corn,
/obj/item/reagent_containers/food/snacks/grown/corn,
/obj/item/reagent_containers/food/snacks/grown/corn,
/obj/item/reagent_containers/food/snacks/grown/corn,
/obj/item/reagent_containers/food/snacks/grown/corn,
/obj/item/reagent_containers/food/snacks/grown/corn,
/obj/item/reagent_containers/food/snacks/grown/corn,
/obj/item/reagent_containers/food/snacks/grown/corn,
/obj/item/reagent_containers/food/snacks/grown/corn,
/obj/item/reagent_containers/food/snacks/meat/slab,
/obj/item/reagent_containers/food/snacks/meat/slab,
/obj/item/reagent_containers/food/snacks/meat/slab,
/obj/item/reagent_containers/food/snacks/meat/slab,
/obj/item/reagent_containers/food/snacks/meat/slab,
/obj/item/reagent_containers/food/snacks/meat/slab,
/obj/item/reagent_containers/food/snacks/grown/carrot,
/obj/item/reagent_containers/food/snacks/grown/carrot,
/obj/item/reagent_containers/food/snacks/grown/carrot,
/obj/item/reagent_containers/food/snacks/grown/carrot,
/obj/item/reagent_containers/food/snacks/grown/carrot,
/obj/item/reagent_containers/food/snacks/grown/carrot,
/obj/item/reagent_containers/food/snacks/grown/carrot,
/obj/item/reagent_containers/food/snacks/grown/carrot,
/obj/item/reagent_containers/food/snacks/grown/carrot,
/obj/item/reagent_containers/food/snacks/grown/eggplant,
/obj/item/reagent_containers/food/snacks/grown/eggplant,
/obj/item/reagent_containers/food/snacks/grown/eggplant,
/obj/item/reagent_containers/food/snacks/grown/eggplant,
/obj/item/reagent_containers/food/snacks/grown/eggplant,
/obj/item/reagent_containers/food/snacks/grown/eggplant,
/obj/item/reagent_containers/food/snacks/grown/eggplant,
/obj/item/reagent_containers/food/snacks/grown/eggplant,
/obj/item/reagent_containers/food/snacks/grown/eggplant,
/obj/item/reagent_containers/food/snacks/grown/eggplant,
/obj/item/reagent_containers/food/snacks/grown/corn,
/obj/item/reagent_containers/food/snacks/grown/corn,
/obj/item/reagent_containers/food/snacks/grown/corn,
/obj/item/reagent_containers/food/snacks/grown/corn,
/obj/item/reagent_containers/food/snacks/grown/corn,
/obj/item/reagent_containers/food/snacks/grown/corn,
/obj/item/reagent_containers/food/snacks/grown/corn,
/obj/item/reagent_containers/food/snacks/grown/corn,
/obj/item/reagent_containers/food/snacks/grown/corn,
/obj/item/reagent_containers/food/snacks/grown/corn,
/obj/item/reagent_containers/food/snacks/grown/corn,
/obj/item/reagent_containers/food/snacks/meat/slab,
/obj/item/reagent_containers/food/snacks/meat/slab,
/obj/item/reagent_containers/food/snacks/meat/slab,
/obj/item/reagent_containers/food/snacks/grown/grapes,
/obj/item/reagent_containers/food/snacks/grown/grapes,
/obj/item/reagent_containers/food/snacks/grown/grapes,
/obj/item/reagent_containers/food/snacks/grown/grapes,
/obj/item/reagent_containers/food/snacks/grown/grapes,
/obj/item/reagent_containers/food/snacks/grown/grapes,
/obj/item/reagent_containers/food/snacks/grown/grapes,
/obj/item/reagent_containers/food/snacks/grown/grapes,
/obj/item/reagent_containers/food/snacks/grown/grapes,
/obj/item/reagent_containers/food/snacks/grown/grapes,
/obj/item/reagent_containers/food/snacks/grown/grapes,
/obj/item/reagent_containers/food/snacks/grown/grapes,
/obj/item/reagent_containers/food/snacks/grown/ambrosia/vulgaris,
/obj/item/reagent_containers/food/snacks/grown/ambrosia/vulgaris,
/obj/item/reagent_containers/food/snacks/grown/ambrosia/vulgaris,
/obj/item/reagent_containers/food/snacks/grown/ambrosia/vulgaris,
/obj/item/reagent_containers/food/snacks/grown/ambrosia/vulgaris,
/obj/item/reagent_containers/food/snacks/grown/ambrosia/vulgaris,
/obj/item/reagent_containers/food/snacks/grown/ambrosia/vulgaris,
/obj/item/reagent_containers/food/snacks/grown/ambrosia/vulgaris,
/obj/item/reagent_containers/food/snacks/grown/ambrosia/vulgaris,
/obj/item/reagent_containers/food/snacks/grown/ambrosia/vulgaris,
/obj/item/reagent_containers/food/snacks/grown/potato,
/obj/item/reagent_containers/food/snacks/grown/potato,
/obj/item/reagent_containers/food/snacks/grown/potato,
/obj/item/reagent_containers/food/snacks/grown/potato,
/obj/item/reagent_containers/food/snacks/grown/potato,
/obj/item/reagent_containers/food/snacks/grown/potato,
/obj/item/reagent_containers/food/snacks/grown/potato,
/obj/item/reagent_containers/food/snacks/grown/potato,
/obj/item/reagent_containers/food/snacks/grown/potato,
/obj/item/reagent_containers/food/snacks/grown/potato,
/obj/item/reagent_containers/food/snacks/grown/potato/sweet,
/obj/item/reagent_containers/food/snacks/grown/potato/sweet,
/obj/item/reagent_containers/food/snacks/grown/potato/sweet,
/obj/item/reagent_containers/food/snacks/grown/potato/sweet,
/obj/item/reagent_containers/food/snacks/grown/potato/sweet,
/obj/item/reagent_containers/food/snacks/grown/potato/sweet,
/obj/item/reagent_containers/food/snacks/grown/potato/sweet,
/obj/item/reagent_containers/food/snacks/grown/potato/sweet,
/obj/item/reagent_containers/food/snacks/grown/potato/sweet,
/obj/item/reagent_containers/food/snacks/grown/potato/sweet,
/turf/open/indestructible/ground/outside/dirt,
/area/survivalpod)
"R" = (
/obj/machinery/microwave/stove,
/turf/open/indestructible/ground/outside/dirt,
/area/survivalpod)
"S" = (
/turf/open/floor/f13/wood,
/area/survivalpod)
"T" = (
/obj/structure/campfire/stove,
/turf/open/floor/f13/wood,
/area/survivalpod)
"W" = (
/obj/structure/table,
/obj/machinery/chem_dispenser/drinks/beer{
	dir = 4
	},
/turf/open/indestructible/ground/outside/dirt{
	dir = 8;
	icon_state = "dirt"
	},
/area/survivalpod)
"X" = (
/obj/structure/chair,
/turf/open/floor/plating/f13/outside/desert,
/area/survivalpod)
"Y" = (
/turf/open/indestructible/ground/outside/dirt{
	icon_state = "dirt"
	},
/area/survivalpod)

(1,1,1) = {"
a
a
a
a
a
a
a
a
a
"}
(2,1,1) = {"
a
g
w
s
u
s
w
g
a
"}
(3,1,1) = {"
a
x
w
w
R
w
w
C
a
"}
(4,1,1) = {"
a
D
w
w
q
w
w
z
a
"}
(5,1,1) = {"
a
Q
w
w
w
w
w
n
a
"}
(6,1,1) = {"
a
a
b
J
t
r
W
a
a
"}
(7,1,1) = {"
a
O
E
Y
w
y
E
O
a
"}
(8,1,1) = {"
a
E
E
Y
w
y
E
E
a
"}
(9,1,1) = {"
E
X
e
B
w
d
e
I
E
"}
(10,1,1) = {"
E
X
e
B
w
d
e
I
E
"}
(11,1,1) = {"
E
X
e
B
w
d
e
I
E
"}
(12,1,1) = {"
E
E
E
Y
w
y
E
E
E
"}
(13,1,1) = {"
a
a
a
a
H
a
a
a
a
"}
(14,1,1) = {"
a
c
S
S
S
S
S
h
a
"}
(15,1,1) = {"
a
m
S
S
S
S
S
h
a
"}
(16,1,1) = {"
a
P
S
S
T
S
S
h
a
"}
(17,1,1) = {"
a
a
a
a
a
a
a
a
a
"}
