"a" = (/obj/structure/fence/corner/wooden{dir = 8},/turf/open/floor/plating/f13/outside/desert,/area/f13/wasteland)
"e" = (/obj/item/shovel,/turf/open/indestructible/ground/outside/dirt,/area/f13/wasteland)
"f" = (/obj/structure/table/wood,/obj/effect/spawner/lootdrop/f13/foodspawner,/obj/effect/spawner/lootdrop/f13/foodspawner,/turf/open/floor/f13/wood,/area/survivalpod)
"g" = (/obj/structure/fence/corner/wooden,/turf/open/floor/plating/f13/outside/desert,/area/f13/wasteland)
"i" = (/obj/structure/fermenting_barrel,/turf/open/floor/f13/wood,/area/survivalpod)
"j" = (/obj/item/reagent_containers/glass/bucket,/turf/open/indestructible/ground/outside/dirt,/area/f13/wasteland)
"l" = (/obj/structure/table/wood,/obj/item/kitchen/knife,/obj/item/flashlight/lamp,/turf/open/floor/f13/wood,/area/survivalpod)
"m" = (/turf/open/floor/plating/f13/outside/desert,/area/f13/wasteland)
"n" = (/obj/structure/fence/wooden{pixel_y = 2},/turf/open/floor/plating/f13/outside/desert,/area/f13/wasteland)
"p" = (/obj/structure/legion_extractor,/turf/open/floor/plating/f13/outside/desert,/area/f13/wasteland)
"r" = (/obj/structure/bed,/obj/item/bedsheet/brown,/turf/open/floor/f13/wood,/area/survivalpod)
"s" = (/obj/structure/sink/puddle,/turf/open/floor/plating/f13/outside/desert,/area/f13/wasteland)
"u" = (/obj/structure/table/wood,/obj/machinery/microwave,/turf/open/floor/f13/wood,/area/survivalpod)
"v" = (/turf/open/indestructible/ground/outside/dirt,/area/f13/wasteland)
"y" = (/turf/closed/wall/f13/tentwall,/area/survivalpod)
"A" = (/obj/machinery/biogenerator,/turf/open/floor/plating/f13/outside/desert,/area/f13/wasteland)
"B" = (/obj/structure/fence/wooden{pixel_y = -8},/turf/open/floor/plating/f13/outside/desert,/area/f13/wasteland)
"D" = (/obj/structure/fence/wooden{dir = 4},/turf/open/floor/plating/f13/outside/desert,/area/f13/wasteland)
"E" = (/obj/structure/fence/wooden{pixel_y = -8},/obj/structure/fence/wooden{pixel_y = 2},/turf/open/floor/plating/f13/outside/desert,/area/f13/wasteland)
"F" = (/obj/structure/reagent_dispensers/compostbin,/turf/open/floor/plating/f13/outside/desert,/area/f13/wasteland)
"G" = (/obj/machinery/hydroponics/soil,/turf/open/floor/plating/f13/outside/desert,/area/f13/wasteland)
"H" = (/obj/machinery/vending/hydronutrients,/turf/open/floor/f13/wood,/area/survivalpod)
"J" = (/obj/structure/simple_door/tent,/turf/open/floor/f13/wood{icon_state = "housewood2"; tag = "icon-housewood2"},/area/survivalpod)
"K" = (/turf/open/indestructible/ground/outside/dirt{dir = 4; icon_state = "dirt"},/area/f13/wasteland)
"M" = (/turf/open/indestructible/ground/outside/dirt{dir = 8; icon_state = "dirt"; tag = "icon-dirt (WEST)"},/area/f13/wasteland)
"O" = (/turf/open/floor/f13/wood,/area/survivalpod)
"Q" = (/obj/structure/fence/corner/wooden{dir = 4},/turf/open/floor/plating/f13/outside/desert,/area/f13/wasteland)
"S" = (/obj/structure/closet/f13/leigon/plants,/obj/item/reagent_containers/food/snacks/grown/wheat,/obj/item/reagent_containers/food/snacks/grown/wheat,/obj/item/reagent_containers/food/snacks/grown/wheat,/obj/item/reagent_containers/food/snacks/grown/wheat,/obj/item/reagent_containers/food/snacks/grown/wheat,/obj/item/reagent_containers/food/snacks/grown/wheat,/turf/open/floor/f13/wood,/area/survivalpod)
"T" = (/obj/structure/fence/wooden{pixel_y = 2},/obj/structure/fence/wooden{pixel_y = 2},/turf/open/floor/plating/f13/outside/desert,/area/f13/wasteland)
"V" = (/mob/living/simple_animal/cow/brahmin,/turf/open/floor/plating/f13/outside/desert,/area/f13/wasteland)
"X" = (/obj/machinery/smartfridge/bottlerack/seedbin,/turf/open/floor/f13/wood,/area/survivalpod)
"Y" = (/obj/structure/simple_door/metal/fence{dir = 8},/turf/open/floor/plating/f13/outside/desert,/area/f13/wasteland)
"Z" = (/obj/machinery/vending/hydroseeds,/turf/open/floor/f13/wood,/area/survivalpod)

(1,1,1) = {"
aDDyyyyyyymmm
nAvyfuHXrymmm
nsjylOOOOymmm
nevyZOOSiymmm
npvyyyOyyymmm
nFvvvyJyaDDDQ
TGGGvvvMnmVmE
nGGGmKvMYmmmB
EGGGmKvMBVmVB
aDDDgKvMaDDDg
"}
