"a" = (/turf/open/floor/plating/f13/outside/desert,/area/f13/wasteland)
"b" = (/obj/item/candle/tribal_torch,/turf/open/indestructible/ground/outside/dirt{dir = 1; icon_state = "dirt"},/area/survivalpod)
"c" = (/obj/structure/campfire,/turf/open/floor/plating/f13/outside/desert,/area/survivalpod)
"f" = (/turf/closed/wall/f13/tentwall,/area/survivalpod)
"h" = (/obj/structure/closet/crate/wicker,/turf/open/indestructible/ground/outside/dirt,/area/survivalpod)
"i" = (/obj/structure/bed,/obj/item/bedsheet/brown,/turf/open/floor/f13/wood,/area/survivalpod)
"n" = (/turf/open/indestructible/ground/outside/dirt{dir = 1; icon_state = "dirtcorner"},/area/survivalpod)
"o" = (/obj/structure/chair/f13foldupchair,/turf/open/indestructible/ground/outside/dirt{dir = 4; icon_state = "dirtcorner"},/area/survivalpod)
"u" = (/obj/machinery/workbench,/turf/open/indestructible/ground/outside/dirt,/area/survivalpod)
"w" = (/obj/machinery/workbench/forge,/turf/open/indestructible/ground/outside/dirt,/area/survivalpod)
"x" = (/obj/structure/table/wood,/turf/open/indestructible/ground/outside/dirt,/area/survivalpod)
"z" = (/turf/open/indestructible/ground/outside/dirt{dir = 9; icon_state = "dirt"},/area/survivalpod)
"F" = (/obj/structure/chair/f13foldupchair{dir = 8},/turf/open/floor/plating/f13/outside/desert,/area/survivalpod)
"G" = (/turf/open/indestructible/ground/outside/dirt{dir = 1; icon_state = "dirt"},/area/survivalpod)
"H" = (/obj/structure/simple_door/tent,/turf/open/floor/f13/wood,/area/survivalpod)
"J" = (/turf/open/indestructible/ground/outside/dirt{dir = 5; icon_state = "dirt"; tag = "icon-dirt (NORTHEAST)"},/area/survivalpod)
"K" = (/obj/structure/table/wood,/obj/effect/spawner/lootdrop/f13/alcoholspawner,/obj/effect/spawner/lootdrop/f13/alcoholspawner,/obj/effect/spawner/lootdrop/f13/alcoholspawner,/turf/open/indestructible/ground/outside/dirt,/area/survivalpod)
"M" = (/obj/structure/table/wood,/obj/effect/spawner/lootdrop/f13/foodspawner,/obj/effect/spawner/lootdrop/f13/foodspawner,/obj/effect/spawner/lootdrop/f13/foodspawner,/turf/open/floor/f13/wood,/area/survivalpod)
"N" = (/turf/open/indestructible/ground/outside/dirt,/area/survivalpod)
"O" = (/obj/structure/rack,/obj/item/storage/toolbox/mechanical/old,/obj/item/stack/crafting/goodparts/five,/obj/item/stack/crafting/metalparts/three,/obj/item/stack/sheet/metal/twenty,/obj/item/stack/crafting/electronicparts/three,/turf/open/indestructible/ground/outside/dirt,/area/survivalpod)
"R" = (/obj/structure/chair/f13foldupchair{dir = 4; icon_state = "f13foldupchair"},/turf/open/floor/plating/f13/outside/desert,/area/survivalpod)
"S" = (/turf/open/floor/plating/f13/outside/desert,/area/survivalpod)
"W" = (/turf/open/floor/f13/wood,/area/survivalpod)
"Y" = (/obj/structure/rack,/obj/machinery/autolathe/constructionlathe,/turf/open/indestructible/ground/outside/dirt,/area/survivalpod)

(1,1,1) = {"
fffffffffff
fwNYhuOfMif
fNNNNNNHWWf
fNNNNNNffff
fbJKxzbfaaa
aSoGGnaaaaa
aRcFaaaaaaa
"}
