"aT" = (/obj/structure/destructible/tribal_torch/wall/lit{dir = 8},/turf/open/floor/wood_common/wood_common_dark,/area/f13/building/khanfort)
"bm" = (/obj/structure/rack/shelf_metal,/obj/item/clothing/shoes/f13/military/khan,/obj/item/clothing/under/f13/khan/booty,/obj/item/clothing/suit/armor/medium/vest/breastplate/khan,/turf/open/floor/wood_common/wood_common_dark,/area/f13/building/khanfort)
"cl" = (/obj/structure/chair/pew{dir = 4},/turf/open/indestructible/ground/inside/mountain,/area/f13/tunnel/khanfort)
"cu" = (/obj/structure/rack/shelf_metal,/obj/item/clothing/shoes/f13/military/khan,/obj/item/clothing/head/helmet/f13/khan/bandana,/obj/item/clothing/under/f13/khan,/turf/open/floor/wood_common/wood_common_dark,/area/f13/building/khanfort)
"do" = (/obj/effect/spawner/structure/window/hollow,/turf/open/floor/wood_common/wood_common_dark,/area/f13/building/khanfort)
"dW" = (/obj/structure/destructible/tribal_torch/wall/lit,/turf/open/indestructible/ground/inside/mountain,/area/f13/wasteland)
"fm" = (/obj/structure/chair/pew/right{dir = 4},/turf/open/indestructible/ground/inside/mountain,/area/f13/tunnel/khanfort)
"fB" = (/obj/structure/fence/corner,/turf/open/indestructible/ground/outside/desert,/area/f13/wasteland)
"gC" = (/obj/structure/destructible/tribal_torch/wall/lit{dir = 8},/turf/open/indestructible/ground/inside/mountain,/area/f13/tunnel/khanfort)
"gZ" = (/obj/structure/simple_door/wood,/turf/open/floor/wood_common/wood_common_dark,/area/f13/building/khanfort)
"hg" = (/obj/structure/destructible/tribal_torch/lit,/turf/open/indestructible/ground/outside/desert,/area/f13/wasteland)
"hh" = (/obj/structure/rack/shelf_metal,/obj/item/clothing/under/f13/khan/shorts,/turf/open/floor/wood_common/wood_common_dark,/area/f13/building/khanfort)
"hi" = (/obj/structure/chair/f13chair1{dir = 4},/turf/open/indestructible/ground/outside/desert,/area/f13/wasteland)
"hw" = (/obj/structure/wreck/trash/two_tire,/turf/open/indestructible/ground/outside/desert,/area/f13/wasteland)
"jc" = (/obj/structure/table,/obj/item/stack/medical/ointment/twelve,/obj/item/stack/medical/ointment/twelve,/obj/item/stack/medical/suture/emergency/fifteen,/obj/item/stack/medical/suture/emergency/fifteen,/obj/item/stack/medical/bruise_pack,/turf/open/indestructible/ground/inside/mountain,/area/f13/tunnel/khanfort)
"jk" = (/obj/structure/closet/fridge/meat,/turf/open/indestructible/ground/inside/mountain,/area/f13/wasteland)
"jl" = (/obj/structure/destructible/tribal_torch/wall/lit{dir = 8},/obj/effect/decal/cleanable/dirt,/turf/open/floor/wood_common/wood_common_dark,/area/f13/building/khanfort)
"jS" = (/obj/item/reagent_containers/glass/bucket,/turf/open/indestructible/ground/inside/dirt,/area/f13/wasteland)
"kf" = (/turf/closed/wall/f13/tentwall,/area/f13/building/khanfort)
"kB" = (/obj/structure/rack/shelf_metal,/obj/item/clothing/head/helmet/f13/khan,/obj/item/clothing/suit/armor/medium/vest/breastplate/khan,/turf/open/floor/wood_common/wood_common_dark,/area/f13/building/khanfort)
"kQ" = (/obj/structure/chair/f13chair1{dir = 1},/turf/open/indestructible/ground/outside/desert,/area/f13/wasteland)
"kR" = (/obj/item/flag/khan,/turf/open/indestructible/ground/outside/desert,/area/f13/wasteland)
"lF" = (/obj/structure/fence/corner{dir = 8},/turf/open/indestructible/ground/outside/desert,/area/f13/wasteland)
"lK" = (/obj/structure/destructible/tribal_torch/wall/lit{dir = 4},/obj/effect/decal/cleanable/dirt,/turf/open/indestructible/ground/inside/mountain,/area/f13/tunnel/khanfort)
"lX" = (/obj/structure/chair/pew/left{dir = 4},/turf/open/indestructible/ground/inside/mountain,/area/f13/tunnel/khanfort)
"me" = (/obj/structure/wreck/trash/five_tires,/turf/open/indestructible/ground/outside/desert,/area/f13/wasteland)
"ms" = (/obj/structure/wreck/trash/four_barrels,/turf/open/indestructible/ground/outside/desert,/area/f13/wasteland)
"mw" = (/turf/closed/wall/f13/tentwall,/area/f13/wasteland)
"or" = (/obj/structure/table/wood/club,/obj/item/candle,/turf/open/indestructible/ground/inside/mountain,/area/f13/tunnel/khanfort)
"oB" = (/obj/structure/chair/sofa/corp,/turf/open/indestructible/ground/outside/desert,/area/f13/wasteland)
"oF" = (/obj/structure/table,/obj/machinery/reagentgrinder,/turf/open/indestructible/ground/inside/mountain,/area/f13/wasteland)
"oN" = (/obj/structure/table,/obj/item/storage/bag/tray,/obj/item/reagent_containers/glass/bucket,/obj/item/candle,/turf/open/indestructible/ground/inside/mountain,/area/f13/wasteland)
"oY" = (/obj/structure/simple_door/tent,/turf/open/indestructible/ground/inside/dirt,/area/f13/building/khanfort)
"pw" = (/obj/structure/chair/pew{dir = 8},/turf/open/indestructible/ground/inside/mountain,/area/f13/tunnel/khanfort)
"pR" = (/turf/open/indestructible/ground/outside/gravel/path_desert{dir = 1},/area/f13/wasteland)
"pV" = (/obj/structure/closet/fridge/standard,/turf/open/indestructible/ground/inside/mountain,/area/f13/wasteland)
"qe" = (/obj/structure/rack/shelf_metal,/obj/item/clothing/head/helmet/f13/khan/fullhelm,/obj/item/clothing/under/f13/khan,/turf/open/floor/wood_common/wood_common_dark,/area/f13/building/khanfort)
"ql" = (/obj/structure/simple_door/brokenglass,/turf/open/indestructible/ground/inside/mountain,/area/f13/tunnel/khanfort)
"rd" = (/obj/structure/rack/shelf_metal,/obj/item/clothing/head/helmet/f13/khan/fullhelm,/obj/item/clothing/under/f13/khan,/obj/effect/decal/cleanable/dirt,/turf/open/floor/wood_common/wood_common_dark,/area/f13/building/khanfort)
"rq" = (/turf/closed/wall/mineral/wood/nonmetal,/area/f13/tunnel/khanfort)
"rL" = (/turf/open/indestructible/ground/outside/gravel/path_desert,/area/f13/wasteland)
"rS" = (/obj/structure/rack/shelf_metal,/obj/item/clothing/head/helmet/f13/khan/bandana,/turf/open/floor/wood_common/wood_common_dark,/area/f13/building/khanfort)
"rX" = (/obj/structure/destructible/tribal_torch/wall/lit{dir = 1; pixel_y = 17},/turf/open/indestructible/ground/inside/mountain,/area/f13/wasteland)
"ss" = (/obj/structure/destructible/tribal_torch/wall/lit{dir = 1; pixel_y = 28},/obj/structure/table/wood/club,/turf/open/indestructible/ground/inside/mountain,/area/f13/tunnel/khanfort)
"tI" = (/obj/structure/chair/sofa/corp/left,/turf/open/indestructible/ground/outside/desert,/area/f13/wasteland)
"tV" = (/obj/structure/bed/mattress,/turf/open/indestructible/ground/inside/dirt,/area/f13/building/khanfort)
"tY" = (/obj/structure/fence/corner{dir = 1},/turf/open/indestructible/ground/outside/desert,/area/f13/wasteland)
"uV" = (/obj/structure/rack/shelf_metal,/obj/item/clothing/head/helmet/f13/khan/bandana,/obj/effect/decal/cleanable/dirt,/turf/open/floor/wood_common/wood_common_dark,/area/f13/building/khanfort)
"vi" = (/obj/structure/chair/sofa/corp/right,/turf/open/indestructible/ground/outside/desert,/area/f13/wasteland)
"vn" = (/obj/machinery/door/unpowered/securedoor/khandoor,/turf/open/floor/wood_common/wood_common_dark,/area/f13/building/khanfort)
"vp" = (/obj/structure/chair/pew/left{dir = 8},/turf/open/indestructible/ground/inside/mountain,/area/f13/tunnel/khanfort)
"vy" = (/obj/structure/rack/shelf_metal,/obj/item/clothing/suit/toggle/labcoat/khan_jacket/armored,/obj/item/clothing/under/f13/khan/booty,/turf/open/floor/wood_common/wood_common_dark,/area/f13/building/khanfort)
"vz" = (/obj/structure/bonfire/prelit,/turf/open/indestructible/ground/outside/desert,/area/f13/wasteland)
"vP" = (/obj/structure/wreck/trash/three_barrels,/turf/open/indestructible/ground/outside/desert,/area/f13/wasteland)
"wn" = (/obj/effect/decal/cleanable/dirt,/obj/structure/destructible/tribal_torch/lit,/turf/open/floor/wood_common/wood_common_dark,/area/f13/building/khanfort)
"ws" = (/turf/open/indestructible/ground/outside/gravel/path_desert{dir = 4},/area/f13/wasteland)
"wu" = (/turf/closed/wall/f13/sunset/brick_small_dark,/area/f13/building/khanfort)
"wX" = (/obj/structure/table/optable,/turf/open/indestructible/ground/inside/mountain,/area/f13/tunnel/khanfort)
"xM" = (/obj/structure/destructible/tribal_torch/wall/lit{dir = 1; pixel_y = 28},/obj/structure/wreck/trash/one_barrel,/turf/open/indestructible/ground/outside/desert,/area/f13/wasteland)
"zb" = (/obj/structure/chair/f13chair1{dir = 8},/turf/open/indestructible/ground/outside/desert,/area/f13/wasteland)
"zt" = (/obj/structure/fence{dir = 4},/turf/open/indestructible/ground/outside/desert,/area/f13/wasteland)
"zC" = (/obj/structure/destructible/tribal_torch/wall/lit{dir = 8},/turf/open/indestructible/ground/outside/desert,/area/f13/wasteland)
"zD" = (/obj/structure/wreck/trash/brokenvendor,/turf/open/indestructible/ground/outside/desert,/area/f13/wasteland)
"zR" = (/turf/closed/mineral/strong/wasteland,/area/f13/tunnel/khanfort)
"zU" = (/obj/structure/campfire,/turf/open/indestructible/ground/outside/desert,/area/f13/wasteland)
"Ag" = (/obj/effect/decal/cleanable/dirt,/turf/open/indestructible/ground/inside/mountain,/area/f13/wasteland)
"Ai" = (/turf/open/indestructible/ground/outside/desert,/area/f13/wasteland)
"Bb" = (/obj/structure/wreck/trash/machinepile,/turf/open/indestructible/ground/outside/desert,/area/f13/wasteland)
"Be" = (/turf/closed/indestructible/f13/obsidian,/area/f13/tunnel/khanfort)
"BX" = (/obj/structure/table/wood/club,/turf/open/indestructible/ground/inside/mountain,/area/f13/tunnel/khanfort)
"Cn" = (/turf/closed/wall/mineral/wood/nonmetal,/area/f13/building/khanfort)
"CL" = (/obj/structure/fence,/turf/open/indestructible/ground/outside/desert,/area/f13/wasteland)
"CM" = (/obj/machinery/smartfridge/bottlerack/drug_storage,/obj/effect/spawner/lootdrop/f13/medical/wasteland/meds/drug,/turf/open/indestructible/ground/inside/mountain,/area/f13/tunnel/khanfort)
"CZ" = (/obj/structure/chair/pew/right{dir = 4},/obj/effect/decal/cleanable/dirt,/turf/open/indestructible/ground/inside/mountain,/area/f13/tunnel/khanfort)
"Dc" = (/obj/effect/spawner/structure/window/hollow,/obj/effect/spawner/structure/window/hollow,/turf/open/floor/wood_common/wood_common_dark,/area/f13/building/khanfort)
"Dk" = (/obj/effect/decal/cleanable/dirt,/obj/structure/chair/comfy/plywood{dir = 4},/turf/open/floor/wood_common/wood_common_dark,/area/f13/building/khanfort)
"DI" = (/obj/item/trash/tray,/turf/open/indestructible/ground/outside/desert,/area/f13/wasteland)
"El" = (/obj/effect/spawner/lootdrop/trash,/turf/open/indestructible/ground/outside/desert,/area/f13/wasteland)
"EL" = (/obj/structure/destructible/tribal_torch/wall/lit{dir = 1; pixel_y = 28},/obj/structure/table/wood/club,/obj/item/candle,/turf/open/indestructible/ground/inside/mountain,/area/f13/tunnel/khanfort)
"FC" = (/obj/structure/destructible/tribal_torch/wall/lit{dir = 1; pixel_y = 28},/obj/structure/chair/pew/right{dir = 4},/turf/open/indestructible/ground/inside/mountain,/area/f13/tunnel/khanfort)
"FM" = (/obj/effect/decal/cleanable/dirt,/turf/closed/wall/mineral/wood/nonmetal,/area/f13/building/khanfort)
"FR" = (/obj/structure/destructible/tribal_torch/wall/lit,/turf/open/floor/wood_common/wood_common_dark,/area/f13/building/khanfort)
"GW" = (/turf/open/indestructible/ground/inside/mountain,/area/f13/wasteland)
"IS" = (/obj/item/reagent_containers/rag,/turf/open/indestructible/ground/inside/dirt,/area/f13/wasteland)
"IZ" = (/turf/open/indestructible/ground/inside/dirt,/area/f13/building/khanfort)
"Ji" = (/obj/structure/wreck/trash/secway,/turf/open/indestructible/ground/outside/desert,/area/f13/wasteland)
"JU" = (/obj/effect/decal/cleanable/dirt,/turf/open/floor/wood_common/wood_common_dark,/area/f13/building/khanfort)
"KJ" = (/obj/structure/closet/crate/bin/trashbin,/turf/open/indestructible/ground/inside/mountain,/area/f13/tunnel/khanfort)
"KO" = (/obj/structure/fence/door,/turf/open/indestructible/ground/outside/gravel/path_desert,/area/f13/wasteland)
"LC" = (/obj/machinery/smartfridge/bottlerack/drug_storage,/obj/effect/spawner/lootdrop/druggie_pill,/turf/open/indestructible/ground/inside/mountain,/area/f13/tunnel/khanfort)
"Mr" = (/turf/open/indestructible/ground/outside/gravel/path_desert{dir = 5},/area/f13/wasteland)
"Mx" = (/obj/structure/destructible/tribal_torch/wall/lit{dir = 1; pixel_y = 28},/obj/structure/wreck/trash/four_barrels,/turf/open/indestructible/ground/outside/desert,/area/f13/wasteland)
"Ne" = (/obj/structure/fence/corner{dir = 4},/turf/open/indestructible/ground/outside/desert,/area/f13/wasteland)
"Nn" = (/turf/open/indestructible/ground/inside/mountain,/area/f13/tunnel/khanfort)
"Nv" = (/obj/structure/closet/crate/grave,/turf/open/indestructible/ground/outside/desert,/area/f13/wasteland)
"NK" = (/turf/open/indestructible/ground/outside/gravel/path_desert/end{dir = 4},/area/f13/wasteland)
"Ob" = (/obj/item/candle/tribal_torch,/turf/open/indestructible/ground/inside/mountain,/area/f13/tunnel/khanfort)
"OM" = (/obj/structure/simple_door/repaired,/turf/open/indestructible/ground/inside/mountain,/area/f13/tunnel/khanfort)
"Pf" = (/obj/structure/destructible/tribal_torch/wall/lit,/turf/open/indestructible/ground/inside/mountain,/area/f13/tunnel/khanfort)
"Pt" = (/obj/structure/wreck/trash/engine,/turf/open/indestructible/ground/outside/desert,/area/f13/wasteland)
"Px" = (/obj/structure/destructible/tribal_torch/wall/lit,/obj/structure/closet/crate/bin/trashbin,/turf/open/indestructible/ground/inside/mountain,/area/f13/tunnel/khanfort)
"Py" = (/obj/machinery/chem_lab/drug_lab,/turf/open/indestructible/ground/inside/mountain,/area/f13/tunnel/khanfort)
"PZ" = (/obj/structure/destructible/tribal_torch/lit,/turf/open/indestructible/ground/inside/mountain,/area/f13/tunnel/khanfort)
"Qa" = (/obj/structure/wreck/trash/one_tire,/turf/open/indestructible/ground/outside/desert,/area/f13/wasteland)
"QN" = (/obj/structure/destructible/tribal_torch/wall/lit{dir = 1; pixel_y = 28},/turf/open/floor/wood_common/wood_common_dark,/area/f13/building/khanfort)
"RP" = (/obj/structure/table,/obj/machinery/microwave,/obj/structure/destructible/tribal_torch/wall/lit{dir = 8},/turf/open/indestructible/ground/inside/mountain,/area/f13/wasteland)
"Sn" = (/obj/effect/decal/cleanable/dirt,/turf/open/indestructible/ground/inside/mountain,/area/f13/tunnel/khanfort)
"SG" = (/obj/structure/closet/crate/bin/trashbin,/turf/open/indestructible/ground/outside/desert,/area/f13/wasteland)
"SI" = (/obj/structure/rack/shelf_metal,/obj/item/clothing/suit/toggle/labcoat/khan_jacket/armored,/obj/item/clothing/under/f13/khan/shorts,/turf/open/floor/wood_common/wood_common_dark,/area/f13/building/khanfort)
"SO" = (/obj/structure/destructible/tribal_torch/wall/lit{dir = 4},/turf/open/indestructible/ground/inside/mountain,/area/f13/wasteland)
"TR" = (/obj/structure/wreck/trash/one_barrel,/turf/open/indestructible/ground/outside/desert,/area/f13/wasteland)
"UG" = (/obj/structure/table,/obj/item/storage/belt/medical/primitive,/obj/item/storage/survivalkit/medical/follower,/obj/item/stack/medical/gauze,/obj/item/stack/medical/gauze,/obj/item/stack/medical/gauze,/obj/item/stack/medical/gauze,/turf/open/indestructible/ground/inside/mountain,/area/f13/tunnel/khanfort)
"UM" = (/turf/open/indestructible/ground/outside/gravel/path_desert{dir = 10},/area/f13/wasteland)
"VG" = (/obj/structure/bed/wooden,/obj/item/bedsheet/pirate,/turf/open/floor/wood_common/wood_common_dark,/area/f13/building/khanfort)
"VY" = (/obj/structure/simple_door/tent,/turf/open/indestructible/ground/inside/dirt,/area/f13/wasteland)
"Wv" = (/obj/effect/overlay/desert/sonora/edge{dir = 4},/obj/effect/overlay/desert/sonora/edge/corner{dir = 1},/obj/effect/overlay/desert/sonora/edge/corner{dir = 4},/turf/open/indestructible/ground/outside/gravel,/area/f13/wasteland)
"WX" = (/obj/structure/fence{dir = 1},/turf/open/indestructible/ground/outside/desert,/area/f13/wasteland)
"Xl" = (/turf/closed/mineral/strong/wasteland,/area/f13/wasteland)
"Xw" = (/obj/structure/rack/shelf_metal,/obj/item/clothing/head/helmet/f13/khan,/turf/open/floor/wood_common/wood_common_dark,/area/f13/building/khanfort)
"XC" = (/obj/structure/rack/shelf_metal,/obj/item/clothing/suit/armor/khan_jacket,/obj/item/clothing/under/f13/khan/shorts,/turf/open/floor/wood_common/wood_common_dark,/area/f13/building/khanfort)
"XD" = (/turf/open/floor/wood_common/wood_common_dark,/area/f13/building/khanfort)
"XO" = (/obj/structure/table/wood,/turf/open/floor/wood_common/wood_common_dark,/area/f13/building/khanfort)
"Yb" = (/obj/structure/chair/pew/right{dir = 8},/turf/open/indestructible/ground/inside/mountain,/area/f13/tunnel/khanfort)
"YO" = (/obj/structure/table,/obj/item/storage/briefcase/medical,/obj/item/storage/survivalkit/medical,/obj/item/storage/survivalkit/medical,/obj/item/storage/survivalkit/medical/tribal,/turf/open/indestructible/ground/inside/mountain,/area/f13/tunnel/khanfort)
"Zm" = (/obj/structure/simple_door/metal/fence{dir = 4},/turf/open/indestructible/ground/outside/desert,/area/f13/wasteland)
"ZG" = (/obj/structure/reagent_dispensers/watertank,/turf/open/indestructible/ground/inside/mountain,/area/f13/wasteland)
"ZO" = (/obj/structure/rack/shelf_metal,/obj/item/clothing/suit/toggle/labcoat/khan_jacket/coat,/turf/open/floor/wood_common/wood_common_dark,/area/f13/building/khanfort)
"ZV" = (/obj/structure/table,/obj/item/storage/backpack/duffelbag/med/surgery,/turf/open/indestructible/ground/inside/mountain,/area/f13/tunnel/khanfort)

(1,1,1) = {"
AiAiAiAiAiAiAiAiAiAiAiAiAiAiAiAiAiAiAiAiAiAiAiAiAiAiAiAiAiAiAiAiAiAiAiXlAiAiAiAiAiAiAiAiAiAiAiAiAiAi
AiAiAiAiAiAiAiAiAiAiAiAiAiAiAiAiAiAiAiAiAiAiAiAiAiAiXlAiAiAiAiAiAiAiXlXlXlXlXlAiAiAiAiAiAiAiAiAiAiAi
AiAiAiAiAiAiAiAiAiAiAiAiAiAiAiAiAiAiAiXlXlXlAiAiAiAiAiAiAiAiAiAiXlXlXlXlXlXlXlXlAiAiAiAiAiAiAiAiAiAi
AiAiAiAiAiAiAiAiAiAiAiAiAiAiXlXlAiXlXlXlXlXlXlXlXlXlXlXlXlXlXlXlXlXlXlXlXlXlXlXlXlAiAiAiAiAiAiAiAiAi
AiAiAiAiAiAiAiAiAiXlAiXlXlXlXlXlXlXlXlXlXlXlXlXlXlXlXlXlXlXlXlXlXlXlXlXlXlXlXlXlXlXlAiAiAiAiAiAiAiAi
AiAiAiAiAiAiAiXlXlAiAiXlXlXlXlXlXlXlXlXlXlXlXlXlXlXlXlXlXlXlXlXlXlXlXlXlXlXlXlXlXlXlAiAiAiAiAiAiAiAi
AiAiAiAiAiAiAiAiAiXlAiXlXlXlXlXlXlXlXlXlXlXlXlXlXlXlXlXlXlzRzRzRzRzRzRzRzRzRzRBezRzRzRAiAiAiAiAiAiAi
AiAiAiAiAiAiAiAiAiAiAiXlXlXlXlXlXlXlXlXlXlXlXlXlXlXlXlXlXlzRjcPZwXZVrqPyLCCMCMzRBezRzRXlAiAiAiAiAiAi
AiAiAiAiAiAiAiXlXlAiXlXlXlXlXlXlXlXlXlXlXlXlXlXljkpVrXGWXlzRUGNnNnNnrqNnNnNnNnObzRzRzRXlXlAiAiAiAiAi
AiAiAiAiAiAiAiAiAiAiXlXlXlXlXlXlXlXlXlXlXlXlXlXlGWAgAgGWXlzRYONnNnNnrqNnNnNnNnNnNnNnzRXlXlAiAiAiAiAi
AiAiAiAiAiAiAiAiXlAiXlXlXlXlXlXlXlXlXlXlXlXlXlXlRPoNoFSOXlzRNnPfNnKJrqPxNnNnPfNnNnNnzRXlXlAiAiAiAiAi
AiAiAiAiAiAiAiAiAiAiXlXlXlXlXlXlXlXlXlXlXlXlXlXlGWAgAgGWXlzROMrqrqrqrqrqrqrqrqrqrqOMzRXlXlAiAiAiAiAi
AiAiAiAiAiAiAiAiAiAiXlXlXlXlXlXlXlXlXlXlXlXlXlXlZGGWdWGWGWOMNnFCBXvpfmssvpCZELvpNnNnzRXlXlAiAiAiAiAi
AiAiAiAiAiAiAiAiAiAiAiCLXlXlXlXlXlXlXlXlXlXlXlXlXlXlXlXlXlzRgCclBXpwclorpwclBXpwNnlKzRXlXlAiAiAiAiAi
AiAiAiAiAiAiAiAiAiAiAiCLXlXlXlXlXlXlXlXlXlXlXlXlXlXlXlXlXlzRNnlXorYblXBXYblXBXYbNnNnzRXlXlAiAiAiAiAi
AiAiAiAiAiAiAiAiAiAiAiCLAiAiAiXlXlXlISjSXlXlXlXlXlXlXlXlXlzRNnSnSnNnNnNnNnNnNnNnSnNnzRXlXlAiAiAiAiAi
AiAiAiAiAiAiAiAiAihgAiCLNvNvNvAiAimwmwVYXlXlXlXlXlXlXlXlXlzRNnSnNnPfSnSnNnNnPfNnNnNnNnXlXlAiAiAiAiAi
AiAiAiAiAiAiAiAiAiAiAiCLAiAiAiAihgAiAiAiAiAiAiAiAiAihwmeXlzRrqqlrqrqrqrqrqrqrqrqrqrqrqXlXlAiAiAiAiAi
AiAiAiAiAiAiAiAiAiAiAiCLAiAiCnCnCnCnCnCnCnAiAiAiAiAiAihwAiAixMpRMxmsBbAiAiAiAiAiAiAiAiAiXlAiAiAiAiAi
AiAiAiAiAiAiAiAiAiAiAiCLAiAiCnVGXDXDXDXDCnAiAiAiAiAiAiAiAivzAipRAiAiAiAiAiAiAiAiAiAivzAiWXAiAiAiAiAi
AiAiAiAiAiAiAiAiAiAiAiCLAiAiCnXDXDwnXDJUgZAiAiAiAiElAiAiAiAiAipRAiAilFztztztztztNeAiAiAiWXAiAiAiAiAi
AiAiAiAiAiAiAiAiAiAiAiCLAiAiFMXDXDXDDkXOCnAiAiAiAiAiAiAiAiAiMrUMAiAiWXAiAiAiAiAiCLAiElAiWXAiAiAiAiAi
AiAiAiAiAiAiAiAiAiAiAiCLAiAiCnCnCnCnCnCnCnAiAiAiAiAiJiAiAiAirLAiQaAiWXAiAiAiAiAiCLAiAiAiWXAiAiAiAiAi
AiAiAiAiAiAiAiAiAiAiAiCLhgAiAiAiAiAiAiAiAiAiAiAiAiAiAiAiAiAiWvwswsNKZmAiAiAiAiAiCLAiAiAiWXAiAiAiAiAi
AiAiAiAiAiAiAiAiAiAiAiCLAiAiwudodowuwudodowuSGAihgAiAiAiAiAirLAiAiAiWXAiAiAiAiAiCLAiAiAiWXAiAiAiAiAi
AiAiAiAiAiAiAiAiAiAiAiCLAiAidoqeJUXCQNkBhhdoAiAiAiAivioBtIAirLAiAiAiWXAiAiAiAiAiCLAiAiAiWXAiAiAiAiAi
AiAiAiAiAiAiAiAiAiAiAiCLAiAidoZOXDcuXDSIXDdoAiAiAihiDIAiAiAirLAiAiAitYztztztztztfBAiAiAiWXAiAiAiAiAi
AiAiAiAiAiAiAiAiAiAiAiCLAiAiwuaTJUXDXDJUXDwuzCAiAiAiAizUAizbrLAihgAiAiElAiAiAiAiAiAiAihgWXAiAiAiAiAi
AiAiAiAiAiAiAiAiAihgAiCLAiAiwujlXDXDXDXDXDvnAiAiAihiAiAiAiAirLAiAiAiAiAiAiAiAiAiAiAiAiAiWXAiAiAiAiAi
AiAiAiAiAiAiAiAiAiAiAiCLAiAiDcbmXDZOXDrdXDwuzCAiAiAiAikQAiAirLAiAiAikfkfoYkfAikfoYkfkfAiWXAiAiAiAiAi
AiAiAiAiAiAiAiAiAiAiAiCLAiAidouVXDvyFRrSXwwuTRAihgAiAiAiAiAirLAiAiPtkfIZIZkfAikfIZIZkfAiWXAiAiAiAiAi
AiAiAiAiAiAiAiAiAiAiAiCLAiAiwudodowuwudodowuvPAiAiAiAihwAiAirLAiAizDkfIZtVkfAikfIZtVkfAiWXAiAiAiAiAi
AiAiAiAiAiAiAiAiAiAiAiCLAiAiAiAiAiAiAiAiAiAiAiAiAiAiAiAiAiAirLAiAiAikfkfkfkfAikfkfkfkfAiWXAihgAiAiAi
AiAiAiAiAiAiAiAiAiAiAiCLAihgAiAiAiAiAiAiAiAiAiAiAiAiAiAiAihgrLhgAiAiAiAiAiAiAiAiAiAiAiAiWXAiAiAiAiAi
AiAiAiAiAiAiAiAiAiAiAitYztztztztztztztztztztztztztztztztztztKOztztztztztztztztztztztztztfBAiAiAiAiAi
AiAiAiAiAiAiAiAiAiAiAiAiAiAiAiAiAiAiAiAiAiAiAiAiAiAiAiAiAikRAikRAiAiAiAiAiAiAiAiAiAiAiAiAiAiAiAiAiAi
AiAiAiAiAiAiAiAiAiAiAiAiAiAiAiAiAiAiAiAiAiAiAihgAiAiAiAiAiAiAiAiAiAiAihgAiAiAiAiAiAiAiAihgAiAiAiAiAi
AiAiAiAiAiAiAiAiAiAiAiAiAiAiAiAiAiAiAiAiAiAiAiAiAiAiAiAiAiAiAiAiAiAiAiAiAiAiAiAiAiAiAiAiAiAiAiAiAiAi
AiAiAiAiAiAiAiAiAiAiAiAiAiAiAiAiAiAiAiAiAiAiAiAiAiAiAiAiAiAiAiAiAiAiAiAiAiAiAiAiAiAiAiAiAiAiAiAiAiAi
AiAiAiAiAiAiAiAiAiAiAiAiAiAiAiAiAiAiAiAiAiAiAiAiAiAiAiAiAiAiAiAiAiAiAiAiAiAiAiAiAiAiAiAiAiAiAiAiAiAi
"}
