"aF" = (/turf/closed/wall/mineral/wood/nonmetal,/area/f13/tunnel/khanfort)
"aP" = (/obj/machinery/door/unpowered/securedoor/khandoor,/turf/open/floor/wood_common/wood_common_dark,/area/f13/building/khanfort)
"bw" = (/obj/structure/wreck/trash/one_tire,/turf/open/indestructible/ground/outside/desert,/area/f13/wasteland)
"bD" = (/obj/structure/fence/corner{dir = 4},/turf/open/indestructible/ground/outside/desert,/area/f13/wasteland)
"bE" = (/obj/structure/chair/f13chair1{dir = 4},/turf/open/indestructible/ground/outside/desert,/area/f13/wasteland)
"bI" = (/obj/structure/destructible/tribal_torch/wall/lit,/turf/open/floor/wood_common/wood_common_dark,/area/f13/building/khanfort)
"db" = (/turf/closed/wall/f13/sunset/brick_small_dark,/area/f13/building/khanfort)
"df" = (/obj/structure/rack/shelf_metal,/obj/item/clothing/shoes/f13/military/khan,/obj/item/clothing/head/helmet/f13/khan/bandana,/obj/item/clothing/under/f13/khan,/turf/open/floor/wood_common/wood_common_dark,/area/f13/building/khanfort)
"dp" = (/obj/structure/simple_door/metal/fence{dir = 4},/turf/open/indestructible/ground/outside/desert,/area/f13/wasteland)
"dq" = (/obj/structure/chair/pew{dir = 4},/turf/open/indestructible/ground/inside/mountain,/area/f13/tunnel/khanfort)
"du" = (/obj/structure/table,/obj/item/storage/bag/tray,/obj/item/reagent_containers/glass/bucket,/obj/item/candle,/turf/open/indestructible/ground/inside/mountain,/area/f13/wasteland)
"ee" = (/obj/structure/simple_door/repaired,/turf/open/indestructible/ground/inside/mountain,/area/f13/tunnel/khanfort)
"er" = (/obj/structure/rack/shelf_metal,/obj/item/clothing/suit/toggle/labcoat/khan_jacket/armored,/obj/item/clothing/under/f13/khan/booty,/turf/open/floor/wood_common/wood_common_dark,/area/f13/building/khanfort)
"eB" = (/turf/open/indestructible/ground/inside/mountain,/area/f13/tunnel/khanfort)
"eT" = (/obj/structure/destructible/tribal_torch/wall/lit{dir = 1; pixel_y = 17},/turf/open/indestructible/ground/inside/mountain,/area/f13/wasteland)
"fw" = (/obj/structure/destructible/tribal_torch/lit,/turf/open/indestructible/ground/inside/mountain,/area/f13/tunnel/khanfort)
"fG" = (/obj/structure/closet/crate/bin/trashbin,/turf/open/indestructible/ground/outside/desert,/area/f13/wasteland)
"fK" = (/obj/effect/decal/cleanable/dirt,/turf/open/indestructible/ground/inside/mountain,/area/f13/wasteland)
"fS" = (/obj/structure/table,/obj/item/storage/briefcase/medical,/obj/item/storage/survivalkit/medical,/obj/item/storage/survivalkit/medical,/obj/item/storage/survivalkit/medical/tribal,/turf/open/indestructible/ground/inside/mountain,/area/f13/tunnel/khanfort)
"gg" = (/turf/closed/wall/mineral/wood/nonmetal,/area/f13/building/khanfort)
"gi" = (/obj/structure/table,/obj/item/storage/belt/medical/primitive,/obj/item/storage/survivalkit/medical/follower,/obj/item/stack/medical/gauze,/obj/item/stack/medical/gauze,/obj/item/stack/medical/gauze,/obj/item/stack/medical/gauze,/turf/open/indestructible/ground/inside/mountain,/area/f13/tunnel/khanfort)
"hh" = (/obj/item/flag/khan,/turf/open/indestructible/ground/outside/desert,/area/f13/wasteland)
"ht" = (/obj/structure/destructible/tribal_torch/wall/lit{dir = 8},/turf/open/floor/wood_common/wood_common_dark,/area/f13/building/khanfort)
"hT" = (/obj/effect/decal/cleanable/dirt,/turf/open/floor/wood_common/wood_common_dark,/area/f13/building/khanfort)
"iK" = (/obj/structure/chair/f13chair1{dir = 8},/turf/open/indestructible/ground/outside/desert,/area/f13/wasteland)
"jH" = (/obj/structure/closet/crate/grave,/turf/open/indestructible/ground/outside/desert,/area/f13/wasteland)
"ks" = (/obj/structure/fence/corner{dir = 1},/turf/open/indestructible/ground/outside/desert,/area/f13/wasteland)
"kN" = (/obj/structure/fence/door,/turf/open/indestructible/ground/outside/gravel/path_desert,/area/f13/wasteland)
"lf" = (/obj/structure/destructible/tribal_torch/wall/lit{dir = 1; pixel_y = 28},/turf/open/floor/wood_common/wood_common_dark,/area/f13/building/khanfort)
"ln" = (/turf/open/indestructible/ground/inside/dirt,/area/f13/building/khanfort)
"lu" = (/turf/open/floor/wood_common/wood_common_dark,/area/f13/building/khanfort)
"ne" = (/obj/structure/chair/pew/right{dir = 4},/obj/effect/decal/cleanable/dirt,/turf/open/indestructible/ground/inside/mountain,/area/f13/tunnel/khanfort)
"nr" = (/obj/structure/chair/f13chair1{dir = 1},/turf/open/indestructible/ground/outside/desert,/area/f13/wasteland)
"nH" = (/obj/structure/fence/corner,/turf/open/indestructible/ground/outside/desert,/area/f13/wasteland)
"nO" = (/obj/effect/spawner/lootdrop/trash,/turf/open/indestructible/ground/outside/desert,/area/f13/wasteland)
"nV" = (/obj/structure/table/optable,/turf/open/indestructible/ground/inside/mountain,/area/f13/tunnel/khanfort)
"oh" = (/obj/structure/wreck/trash/five_tires,/turf/open/indestructible/ground/outside/desert,/area/f13/wasteland)
"ot" = (/obj/machinery/chem_lab/drug_lab,/turf/open/indestructible/ground/inside/mountain,/area/f13/tunnel/khanfort)
"pu" = (/obj/structure/fence,/turf/open/indestructible/ground/outside/desert,/area/f13/wasteland)
"pD" = (/obj/effect/spawner/structure/window/hollow,/turf/open/floor/wood_common/wood_common_dark,/area/f13/building/khanfort)
"pR" = (/obj/item/candle/tribal_torch,/turf/open/indestructible/ground/inside/mountain,/area/f13/tunnel/khanfort)
"qm" = (/turf/closed/wall/f13/tentwall,/area/f13/building/khanfort)
"qs" = (/obj/structure/chair/sofa/corp/right,/turf/open/indestructible/ground/outside/desert,/area/f13/wasteland)
"rC" = (/obj/structure/chair/pew/left{dir = 8},/turf/open/indestructible/ground/inside/mountain,/area/f13/tunnel/khanfort)
"rQ" = (/obj/structure/rack/shelf_metal,/obj/item/clothing/suit/armor/khan_jacket,/obj/item/clothing/under/f13/khan/shorts,/turf/open/floor/wood_common/wood_common_dark,/area/f13/building/khanfort)
"tJ" = (/obj/structure/fence{dir = 4},/turf/open/indestructible/ground/outside/desert,/area/f13/wasteland)
"tP" = (/obj/structure/wreck/trash/brokenvendor,/turf/open/indestructible/ground/outside/desert,/area/f13/wasteland)
"uG" = (/turf/closed/indestructible/f13/obsidian,/area/f13/tunnel/khanfort)
"vE" = (/obj/structure/closet/fridge/meat,/turf/open/indestructible/ground/inside/mountain,/area/f13/wasteland)
"vL" = (/obj/structure/rack/shelf_metal,/obj/item/clothing/under/f13/khan/shorts,/turf/open/floor/wood_common/wood_common_dark,/area/f13/building/khanfort)
"vV" = (/obj/machinery/smartfridge/bottlerack/drug_storage,/obj/effect/spawner/lootdrop/f13/medical/wasteland/meds/drug,/turf/open/indestructible/ground/inside/mountain,/area/f13/tunnel/khanfort)
"wl" = (/obj/structure/campfire,/turf/open/indestructible/ground/outside/desert,/area/f13/wasteland)
"wT" = (/turf/closed/mineral/strong/wasteland,/area/f13/tunnel/khanfort)
"yl" = (/obj/structure/closet/crate/bin/trashbin,/turf/open/indestructible/ground/inside/mountain,/area/f13/tunnel/khanfort)
"yJ" = (/turf/open/indestructible/ground/outside/gravel/path_desert{dir = 1},/area/f13/wasteland)
"yM" = (/turf/open/indestructible/ground/outside/gravel/path_desert/end{dir = 4},/area/f13/wasteland)
"yV" = (/obj/effect/decal/cleanable/dirt,/obj/structure/destructible/tribal_torch/lit,/turf/open/floor/wood_common/wood_common_dark,/area/f13/building/khanfort)
"yX" = (/obj/structure/chair/pew{dir = 8},/turf/open/indestructible/ground/inside/mountain,/area/f13/tunnel/khanfort)
"zt" = (/obj/structure/destructible/tribal_torch/wall/lit,/turf/open/indestructible/ground/inside/mountain,/area/f13/tunnel/khanfort)
"zK" = (/obj/structure/rack/shelf_metal,/obj/item/clothing/head/helmet/f13/khan,/obj/item/clothing/suit/armor/medium/vest/breastplate/khan,/turf/open/floor/wood_common/wood_common_dark,/area/f13/building/khanfort)
"zY" = (/turf/open/indestructible/ground/outside/gravel/path_desert{dir = 10},/area/f13/wasteland)
"zZ" = (/obj/structure/rack/shelf_metal,/obj/item/clothing/suit/toggle/labcoat/khan_jacket/coat,/turf/open/floor/wood_common/wood_common_dark,/area/f13/building/khanfort)
"AL" = (/obj/structure/bed/wooden,/obj/item/bedsheet/pirate,/turf/open/floor/wood_common/wood_common_dark,/area/f13/building/khanfort)
"AP" = (/obj/structure/fence/corner{dir = 8},/turf/open/indestructible/ground/outside/desert,/area/f13/wasteland)
"BO" = (/obj/effect/spawner/structure/window/hollow,/obj/effect/spawner/structure/window/hollow,/turf/open/floor/wood_common/wood_common_dark,/area/f13/building/khanfort)
"BU" = (/obj/structure/fence{dir = 1},/turf/open/indestructible/ground/outside/desert,/area/f13/wasteland)
"BZ" = (/obj/structure/rack/shelf_metal,/obj/item/clothing/head/helmet/f13/khan/bandana,/obj/effect/decal/cleanable/dirt,/turf/open/floor/wood_common/wood_common_dark,/area/f13/building/khanfort)
"CG" = (/obj/structure/wreck/trash/machinepile,/turf/open/indestructible/ground/outside/desert,/area/f13/wasteland)
"Du" = (/obj/effect/decal/cleanable/dirt,/turf/open/indestructible/ground/inside/mountain,/area/f13/tunnel/khanfort)
"Dv" = (/turf/closed/mineral/strong/wasteland,/area/f13/wasteland)
"DJ" = (/obj/structure/destructible/tribal_torch/wall/lit{dir = 4},/obj/effect/decal/cleanable/dirt,/turf/open/indestructible/ground/inside/mountain,/area/f13/tunnel/khanfort)
"Ee" = (/obj/structure/table/wood,/turf/open/floor/wood_common/wood_common_dark,/area/f13/building/khanfort)
"Eh" = (/obj/structure/rack/shelf_metal,/obj/item/clothing/shoes/f13/military/khan,/obj/item/clothing/under/f13/khan/booty,/obj/item/clothing/suit/armor/medium/vest/breastplate/khan,/turf/open/floor/wood_common/wood_common_dark,/area/f13/building/khanfort)
"ES" = (/obj/structure/destructible/tribal_torch/wall/lit{dir = 1; pixel_y = 28},/obj/structure/wreck/trash/one_barrel,/turf/open/indestructible/ground/outside/desert,/area/f13/wasteland)
"FW" = (/obj/structure/bonfire/prelit,/turf/open/indestructible/ground/outside/desert,/area/f13/wasteland)
"FZ" = (/obj/structure/rack/shelf_metal,/obj/item/clothing/head/helmet/f13/khan/fullhelm,/obj/item/clothing/under/f13/khan,/turf/open/floor/wood_common/wood_common_dark,/area/f13/building/khanfort)
"Gl" = (/obj/structure/simple_door/tent,/turf/open/indestructible/ground/inside/dirt,/area/f13/building/khanfort)
"Go" = (/obj/structure/simple_door/tent,/turf/open/indestructible/ground/inside/dirt,/area/f13/wasteland)
"Gu" = (/obj/structure/destructible/tribal_torch/wall/lit{dir = 1; pixel_y = 28},/obj/structure/table/wood/club,/obj/item/candle,/turf/open/indestructible/ground/inside/mountain,/area/f13/tunnel/khanfort)
"GA" = (/obj/structure/chair/pew/right{dir = 8},/turf/open/indestructible/ground/inside/mountain,/area/f13/tunnel/khanfort)
"HE" = (/obj/structure/simple_door/wood,/turf/open/floor/wood_common/wood_common_dark,/area/f13/building/khanfort)
"In" = (/obj/structure/reagent_dispensers/watertank,/turf/open/indestructible/ground/inside/mountain,/area/f13/wasteland)
"JL" = (/obj/effect/overlay/desert/sonora/edge{dir = 4},/obj/effect/overlay/desert/sonora/edge/corner{dir = 1},/obj/effect/overlay/desert/sonora/edge/corner{dir = 4},/turf/open/indestructible/ground/outside/gravel,/area/f13/wasteland)
"JP" = (/obj/structure/destructible/tribal_torch/wall/lit{dir = 1; pixel_y = 28},/obj/structure/table/wood/club,/turf/open/indestructible/ground/inside/mountain,/area/f13/tunnel/khanfort)
"JV" = (/obj/structure/wreck/trash/four_barrels,/turf/open/indestructible/ground/outside/desert,/area/f13/wasteland)
"Kb" = (/obj/structure/destructible/tribal_torch/wall/lit,/obj/structure/closet/crate/bin/trashbin,/turf/open/indestructible/ground/inside/mountain,/area/f13/tunnel/khanfort)
"Ks" = (/obj/structure/rack/shelf_metal,/obj/item/clothing/head/helmet/f13/khan/fullhelm,/obj/item/clothing/under/f13/khan,/obj/effect/decal/cleanable/dirt,/turf/open/floor/wood_common/wood_common_dark,/area/f13/building/khanfort)
"KB" = (/turf/open/indestructible/ground/outside/gravel/path_desert{dir = 5},/area/f13/wasteland)
"KL" = (/obj/structure/chair/sofa/corp/left,/turf/open/indestructible/ground/outside/desert,/area/f13/wasteland)
"KO" = (/obj/structure/wreck/trash/secway,/turf/open/indestructible/ground/outside/desert,/area/f13/wasteland)
"Lv" = (/turf/open/indestructible/ground/outside/gravel/path_desert{dir = 4},/area/f13/wasteland)
"ME" = (/obj/structure/destructible/tribal_torch/wall/lit{dir = 1; pixel_y = 28},/obj/structure/chair/pew/right{dir = 4},/turf/open/indestructible/ground/inside/mountain,/area/f13/tunnel/khanfort)
"Nw" = (/obj/structure/table,/obj/machinery/microwave,/obj/structure/destructible/tribal_torch/wall/lit{dir = 8},/turf/open/indestructible/ground/inside/mountain,/area/f13/wasteland)
"NG" = (/obj/item/trash/tray,/turf/open/indestructible/ground/outside/desert,/area/f13/wasteland)
"NM" = (/obj/structure/destructible/tribal_torch/wall/lit{dir = 8},/turf/open/indestructible/ground/inside/mountain,/area/f13/tunnel/khanfort)
"NV" = (/obj/structure/table/wood/club,/turf/open/indestructible/ground/inside/mountain,/area/f13/tunnel/khanfort)
"OF" = (/obj/effect/decal/cleanable/dirt,/turf/closed/wall/mineral/wood/nonmetal,/area/f13/building/khanfort)
"Pa" = (/obj/structure/table,/obj/item/storage/backpack/duffelbag/med/surgery,/turf/open/indestructible/ground/inside/mountain,/area/f13/tunnel/khanfort)
"Ph" = (/obj/structure/wreck/trash/two_tire,/turf/open/indestructible/ground/outside/desert,/area/f13/wasteland)
"Pi" = (/obj/structure/destructible/tribal_torch/wall/lit{dir = 8},/obj/effect/decal/cleanable/dirt,/turf/open/floor/wood_common/wood_common_dark,/area/f13/building/khanfort)
"Pz" = (/obj/structure/table/wood/club,/obj/item/candle,/turf/open/indestructible/ground/inside/mountain,/area/f13/tunnel/khanfort)
"Qw" = (/obj/structure/destructible/tribal_torch/wall/lit{dir = 4},/turf/open/indestructible/ground/inside/mountain,/area/f13/wasteland)
"QA" = (/obj/structure/table,/obj/machinery/reagentgrinder,/turf/open/indestructible/ground/inside/mountain,/area/f13/wasteland)
"QJ" = (/turf/open/indestructible/ground/outside/gravel/path_desert,/area/f13/wasteland)
"Rk" = (/obj/structure/rack/shelf_metal,/obj/item/clothing/suit/toggle/labcoat/khan_jacket/armored,/obj/item/clothing/under/f13/khan/shorts,/turf/open/floor/wood_common/wood_common_dark,/area/f13/building/khanfort)
"Rv" = (/obj/structure/wreck/trash/one_barrel,/turf/open/indestructible/ground/outside/desert,/area/f13/wasteland)
"RD" = (/obj/structure/bed/mattress,/turf/open/indestructible/ground/inside/dirt,/area/f13/building/khanfort)
"SO" = (/obj/structure/wreck/trash/engine,/turf/open/indestructible/ground/outside/desert,/area/f13/wasteland)
"Tq" = (/obj/structure/closet/fridge/standard,/turf/open/indestructible/ground/inside/mountain,/area/f13/wasteland)
"Tv" = (/turf/open/indestructible/ground/inside/mountain,/area/f13/wasteland)
"TN" = (/obj/structure/chair/pew/left{dir = 4},/turf/open/indestructible/ground/inside/mountain,/area/f13/tunnel/khanfort)
"TO" = (/obj/structure/destructible/tribal_torch/wall/lit{dir = 1; pixel_y = 28},/obj/structure/wreck/trash/four_barrels,/turf/open/indestructible/ground/outside/desert,/area/f13/wasteland)
"Ut" = (/obj/structure/wreck/trash/three_barrels,/turf/open/indestructible/ground/outside/desert,/area/f13/wasteland)
"Uu" = (/obj/structure/rack/shelf_metal,/obj/item/clothing/head/helmet/f13/khan/bandana,/turf/open/floor/wood_common/wood_common_dark,/area/f13/building/khanfort)
"US" = (/obj/structure/destructible/tribal_torch/wall/lit,/turf/open/indestructible/ground/inside/mountain,/area/f13/wasteland)
"UW" = (/obj/structure/destructible/tribal_torch/lit,/turf/open/indestructible/ground/outside/desert,/area/f13/wasteland)
"VA" = (/turf/closed/wall/f13/tentwall,/area/f13/wasteland)
"VZ" = (/obj/item/reagent_containers/glass/bucket,/turf/open/indestructible/ground/inside/dirt,/area/f13/wasteland)
"Wu" = (/obj/structure/destructible/tribal_torch/wall/lit{dir = 8},/turf/open/indestructible/ground/outside/desert,/area/f13/wasteland)
"Ww" = (/obj/structure/chair/comfy/brown{dir = 1},/turf/open/indestructible/ground/inside/mountain,/area/f13/tunnel/khanfort)
"WG" = (/obj/structure/chair/pew/right{dir = 4},/turf/open/indestructible/ground/inside/mountain,/area/f13/tunnel/khanfort)
"WI" = (/obj/machinery/smartfridge/bottlerack/drug_storage,/obj/effect/spawner/lootdrop/druggie_pill,/turf/open/indestructible/ground/inside/mountain,/area/f13/tunnel/khanfort)
"Xf" = (/obj/effect/decal/cleanable/dirt,/obj/structure/chair/comfy/plywood{dir = 4},/turf/open/floor/wood_common/wood_common_dark,/area/f13/building/khanfort)
"Ym" = (/obj/structure/rack/shelf_metal,/obj/item/clothing/head/helmet/f13/khan,/turf/open/floor/wood_common/wood_common_dark,/area/f13/building/khanfort)
"Yu" = (/obj/structure/chair/sofa/corp,/turf/open/indestructible/ground/outside/desert,/area/f13/wasteland)
"YF" = (/turf/open/indestructible/ground/outside/desert,/area/f13/wasteland)
"YW" = (/obj/item/reagent_containers/rag,/turf/open/indestructible/ground/inside/dirt,/area/f13/wasteland)
"Zu" = (/obj/structure/simple_door/brokenglass,/turf/open/indestructible/ground/inside/mountain,/area/f13/tunnel/khanfort)
"ZI" = (/obj/structure/table,/obj/item/stack/medical/ointment/twelve,/obj/item/stack/medical/ointment/twelve,/obj/item/stack/medical/suture/emergency/fifteen,/obj/item/stack/medical/suture/emergency/fifteen,/obj/item/stack/medical/bruise_pack,/turf/open/indestructible/ground/inside/mountain,/area/f13/tunnel/khanfort)

(1,1,1) = {"
YFYFYFYFYFYFYFYFYFYFYFYFYFYFYFYFYFYFYFYFYFYFYFYFYFYFYFYFYFYFYFYFYFYFYFDvYFYFYFYFYFYFYFYFYFYFYFYFYFYF
YFYFYFYFYFYFYFYFYFYFYFYFYFYFYFYFYFYFYFYFYFYFYFYFYFYFDvYFYFYFYFYFYFYFDvDvDvDvDvYFYFYFYFYFYFYFYFYFYFYF
YFYFYFYFYFYFYFYFYFYFYFYFYFYFYFYFYFYFYFDvDvDvYFYFYFYFYFYFYFYFYFYFDvDvDvDvDvDvDvDvYFYFYFYFYFYFYFYFYFYF
YFYFYFYFYFYFYFYFYFYFYFYFYFYFDvDvYFDvDvDvDvDvDvDvDvDvDvDvDvDvDvDvDvDvDvDvDvDvDvDvDvYFYFYFYFYFYFYFYFYF
YFYFYFYFYFYFYFYFYFDvYFDvDvDvDvDvDvDvDvDvDvDvDvDvDvDvDvDvDvDvDvDvDvDvDvDvDvDvDvDvDvDvYFYFYFYFYFYFYFYF
YFYFYFYFYFYFYFDvDvYFYFDvDvDvDvDvDvDvDvDvDvDvDvDvDvDvDvDvDvDvDvDvDvDvDvDvDvDvDvDvDvDvYFYFYFYFYFYFYFYF
YFYFYFYFYFYFYFYFYFDvYFDvDvDvDvDvDvDvDvDvDvDvDvDvDvDvDvDvDvwTwTwTwTwTwTwTwTwTwTuGwTwTwTYFYFYFYFYFYFYF
YFYFYFYFYFYFYFYFYFYFYFDvDvDvDvDvDvDvDvDvDvDvDvDvDvDvDvDvDvwTZIfwnVPaaFotWIvVvVwTuGwTwTDvYFYFYFYFYFYF
YFYFYFYFYFYFYFDvDvYFDvDvDvDvDvDvDvDvDvDvDvDvDvDvvETqeTTvDvwTgieBeBeBaFWweBeBeBpRwTwTwTDvDvYFYFYFYFYF
YFYFYFYFYFYFYFYFYFYFDvDvDvDvDvDvDvDvDvDvDvDvDvDvTvfKfKTvDvwTfSeBeBeBaFeBeBeBeBeBeBeBwTDvDvYFYFYFYFYF
YFYFYFYFYFYFYFYFDvYFDvDvDvDvDvDvDvDvDvDvDvDvDvDvNwduQAQwDvwTeBzteBylaFKbeBeBzteBeBeBwTDvDvYFYFYFYFYF
YFYFYFYFYFYFYFYFYFYFDvDvDvDvDvDvDvDvDvDvDvDvDvDvTvfKfKTvDvwTeeaFaFaFaFaFaFaFaFaFaFeewTDvDvYFYFYFYFYF
YFYFYFYFYFYFYFYFYFYFDvDvDvDvDvDvDvDvDvDvDvDvDvDvInTvUSTvTveeeBMENVrCWGJPrCneGurCeBeBwTDvDvYFYFYFYFYF
YFYFYFYFYFYFYFYFYFYFYFpuDvDvDvDvDvDvDvDvDvDvDvDvDvDvDvDvDvwTNMdqNVyXdqPzyXdqNVyXeBDJwTDvDvYFYFYFYFYF
YFYFYFYFYFYFYFYFYFYFYFpuDvDvDvDvDvDvDvDvDvDvDvDvDvDvDvDvDvwTeBTNPzGATNNVGATNNVGAeBeBwTDvDvYFYFYFYFYF
YFYFYFYFYFYFYFYFYFYFYFpuYFYFYFDvDvDvYWVZDvDvDvDvDvDvDvDvDvwTeBDuDueBeBeBeBeBeBeBDueBwTDvDvYFYFYFYFYF
YFYFYFYFYFYFYFYFYFUWYFpujHjHjHYFYFVAVAGoDvDvDvDvDvDvDvDvDvwTeBDueBztDuDueBeBzteBeBeBeBDvDvYFYFYFYFYF
YFYFYFYFYFYFYFYFYFYFYFpuYFYFYFYFUWYFYFYFYFYFYFYFYFYFPhohDvwTaFZuaFaFaFaFaFaFaFaFaFaFaFDvDvYFYFYFYFYF
YFYFYFYFYFYFYFYFYFYFYFpuYFYFggggggggggggggYFYFYFYFYFYFPhYFYFESyJTOJVCGYFYFYFYFYFYFYFYFYFDvYFYFYFYFYF
YFYFYFYFYFYFYFYFYFYFYFpuYFYFggALlulululuggYFYFYFYFYFYFYFYFFWYFyJYFYFYFYFYFYFYFYFYFYFFWYFBUYFYFYFYFYF
YFYFYFYFYFYFYFYFYFYFYFpuYFYFggluluyVluhTHEYFYFYFYFnOYFYFYFYFYFyJYFYFAPtJtJtJtJtJbDYFYFYFBUYFYFYFYFYF
YFYFYFYFYFYFYFYFYFYFYFpuYFYFOFlululuXfEeggYFYFYFYFYFYFYFYFYFKBzYYFYFBUYFYFYFYFYFpuYFnOYFBUYFYFYFYFYF
YFYFYFYFYFYFYFYFYFYFYFpuYFYFggggggggggggggYFYFYFYFYFKOYFYFYFQJYFbwYFBUYFYFYFYFYFpuYFYFYFBUYFYFYFYFYF
YFYFYFYFYFYFYFYFYFYFYFpuUWYFYFYFYFYFYFYFYFYFYFYFYFYFYFYFYFYFJLLvLvyMdpYFYFYFYFYFpuYFYFYFBUYFYFYFYFYF
YFYFYFYFYFYFYFYFYFYFYFpuYFYFdbpDpDdbdbpDpDdbfGYFUWYFYFYFYFYFQJYFYFYFBUYFYFYFYFYFpuYFYFYFBUYFYFYFYFYF
YFYFYFYFYFYFYFYFYFYFYFpuYFYFpDFZhTrQlfzKvLpDYFYFYFYFqsYuKLYFQJYFYFYFBUYFYFYFYFYFpuYFYFYFBUYFYFYFYFYF
YFYFYFYFYFYFYFYFYFYFYFpuYFYFpDzZludfluRklupDYFYFYFbENGYFYFYFQJYFYFYFkstJtJtJtJtJnHYFYFYFBUYFYFYFYFYF
YFYFYFYFYFYFYFYFYFYFYFpuYFYFdbhthTluluhTludbWuYFYFYFYFwlYFiKQJYFUWYFYFnOYFYFYFYFYFYFYFUWBUYFYFYFYFYF
YFYFYFYFYFYFYFYFYFUWYFpuYFYFdbPilululululuaPYFYFYFbEYFYFYFYFQJYFYFYFYFYFYFYFYFYFYFYFYFYFBUYFYFYFYFYF
YFYFYFYFYFYFYFYFYFYFYFpuYFYFBOEhluzZluKsludbWuYFYFYFYFnrYFYFQJYFYFYFqmqmGlqmYFqmGlqmqmYFBUYFYFYFYFYF
YFYFYFYFYFYFYFYFYFYFYFpuYFYFpDBZluerbIUuYmdbRvYFUWYFYFYFYFYFQJYFYFSOqmlnlnqmYFqmlnlnqmYFBUYFYFYFYFYF
YFYFYFYFYFYFYFYFYFYFYFpuYFYFdbpDpDdbdbpDpDdbUtYFYFYFYFPhYFYFQJYFYFtPqmlnRDqmYFqmlnRDqmYFBUYFYFYFYFYF
YFYFYFYFYFYFYFYFYFYFYFpuYFYFYFYFYFYFYFYFYFYFYFYFYFYFYFYFYFYFQJYFYFYFqmqmqmqmYFqmqmqmqmYFBUYFUWYFYFYF
YFYFYFYFYFYFYFYFYFYFYFpuYFUWYFYFYFYFYFYFYFYFYFYFYFYFYFYFYFUWQJUWYFYFYFYFYFYFYFYFYFYFYFYFBUYFYFYFYFYF
YFYFYFYFYFYFYFYFYFYFYFkstJtJtJtJtJtJtJtJtJtJtJtJtJtJtJtJtJtJkNtJtJtJtJtJtJtJtJtJtJtJtJtJnHYFYFYFYFYF
YFYFYFYFYFYFYFYFYFYFYFYFYFYFYFYFYFYFYFYFYFYFYFYFYFYFYFYFYFhhYFhhYFYFYFYFYFYFYFYFYFYFYFYFYFYFYFYFYFYF
YFYFYFYFYFYFYFYFYFYFYFYFYFYFYFYFYFYFYFYFYFYFYFUWYFYFYFYFYFYFYFYFYFYFYFUWYFYFYFYFYFYFYFYFUWYFYFYFYFYF
YFYFYFYFYFYFYFYFYFYFYFYFYFYFYFYFYFYFYFYFYFYFYFYFYFYFYFYFYFYFYFYFYFYFYFYFYFYFYFYFYFYFYFYFYFYFYFYFYFYF
YFYFYFYFYFYFYFYFYFYFYFYFYFYFYFYFYFYFYFYFYFYFYFYFYFYFYFYFYFYFYFYFYFYFYFYFYFYFYFYFYFYFYFYFYFYFYFYFYFYF
YFYFYFYFYFYFYFYFYFYFYFYFYFYFYFYFYFYFYFYFYFYFYFYFYFYFYFYFYFYFYFYFYFYFYFYFYFYFYFYFYFYFYFYFYFYFYFYFYFYF
"}
