"a" = (/turf/open/indestructible/ground/outside/desert,/area/f13/wasteland)
"c" = (/obj/effect/spawner/structure/window/reinforced,/obj/machinery/door/poddoor/shutters/old{id = "245"},/turf/open/floor/plasteel/f13/vault_floor/floor,/area/f13/vault)
"m" = (/turf/open/floor/plasteel/f13/vault_floor/floor,/area/f13/vault)
"r" = (/obj/item/radio/intercom{frequency = 1361; name = "Vault Intercom"; pixel_x = 32},/turf/open/indestructible/ground/outside/desert,/area/f13/wasteland)
"v" = (/obj/structure/shelf_wood,/turf/open/floor/plasteel/f13/vault_floor/floor,/area/f13/vault)
"C" = (/obj/machinery/button{id = "245"; name = "lockdown"},/turf/closed/wall/r_wall/f13vault{icon_state = "2-i"},/area/f13/vault)
"D" = (/turf/closed/wall/r_wall/f13vault{icon_state = "2-i"},/area/f13/vault)
"F" = (/obj/structure/table/reinforced,/obj/structure/barricade/bars{max_integrity = 800; name = "strong metal bars"; obj_integrity = 800},/obj/machinery/door/poddoor/shutters/old{id = "245"},/turf/open/floor/plasteel/f13/vault_floor/floor,/area/f13/vault)
"N" = (/turf/open/transparent/openspace,/area/f13/vault)
"W" = (/turf/closed/indestructible/vaultdoor,/area/f13/vault)

(1,1,1) = {"
aaaaaaaaaaaaaaaaaaaa
aaaaaaaaaaaaaaaaaaaa
aaaaaaaaaaaaaaaaaaaa
aaaaaaaaaaaaaaaaaaaa
aaaaaaaaaaaaaaaaaaaa
aaaaaaaaaaaaaaaaaaaa
aaaaaarDccDccDaaaaaa
aaaaaaaFmvvvvCWWaaaa
aaaaaaaFmmmmmmNWaaaa
aaaaaaaFmmvvmmNWaaaa
aaaaaaaFmmmmmDWWaaaa
aaaaaaaFmvvvvDaaaaaa
aaaaaaaDccDccDaaaaaa
aaaaaaaaaaaaaaaaaaaa
aaaaaaaaaaaaaaaaaaaa
aaaaaaaaaaaaaaaaaaaa
aaaaaaaaaaaaaaaaaaaa
aaaaaaaaaaaaaaaaaaaa
aaaaaaaaaaaaaaaaaaaa
aaaaaaaaaaaaaaaaaaaa
"}
