"a" = (/turf/closed/mineral,/area/f13/bunker)
"c" = (/turf/open/indestructible/ground/inside/mountain,/area/f13/bunker)
"d" = (/obj/structure/flora/wasteplant/wild_fungus,/turf/open/indestructible/ground/inside/mountain,/area/f13/bunker)
"e" = (/obj/structure/chair/bench,/turf/open/indestructible/ground/inside/mountain,/area/f13/bunker)
"f" = (/obj/effect/spawner/lootdrop/f13/cash_random_low,/turf/open/indestructible/ground/inside/mountain,/area/f13/bunker)
"g" = (/obj/item/crafting/coffee_pot,/obj/structure/table/wood,/turf/open/indestructible/ground/inside/mountain,/area/f13/bunker)
"h" = (/obj/item/chair/wood,/turf/open/indestructible/ground/inside/mountain,/area/f13/bunker)
"i" = (/obj/item/crafting/campfirekit,/turf/open/indestructible/ground/inside/mountain,/area/f13/bunker)
"j" = (/obj/structure/flora/ausbushes/lavendergrass{pixel_x = 0; pixel_y = -7},/turf/open/indestructible/ground/inside/mountain,/area/f13/bunker)
"k" = (/obj/structure/flora/ausbushes/lavendergrass{pixel_x = 12; pixel_y = -21},/turf/open/indestructible/ground/inside/mountain,/area/f13/bunker)
"l" = (/obj/effect/overlay/rockfloor_side{icon_state = "rockfloor_side"; dir = 1},/obj/effect/overlay/rockfloor_side{icon_state = "rockfloor_side"; dir = 8},/obj/structure/flora/ausbushes/lavendergrass{pixel_x = 5; pixel_y = -9},/turf/open/floor/grass,/area/f13/bunker)
"m" = (/obj/effect/overlay/rockfloor_side{icon_state = "rockfloor_side"; dir = 1},/turf/open/floor/grass,/area/f13/bunker)
"n" = (/obj/effect/overlay/rockfloor_side{icon_state = "rockfloor_side"; dir = 1},/obj/structure/flora/ausbushes/lavendergrass{pixel_x = 0; pixel_y = -7},/turf/open/floor/grass,/area/f13/bunker)
"o" = (/obj/effect/overlay/rockfloor_side{icon_state = "rockfloor_side"; dir = 1},/obj/structure/flora/ausbushes/lavendergrass{pixel_x = 2; pixel_y = 3},/turf/open/floor/grass,/area/f13/bunker)
"p" = (/obj/effect/overlay/rockfloor_side{icon_state = "rockfloor_side"; dir = 1},/obj/effect/overlay/rockfloor_side{icon_state = "rockfloor_side"; dir = 4},/obj/effect/spawner/lootdrop/f13/seedspawner,/turf/open/floor/grass,/area/f13/bunker)
"q" = (/obj/structure/flora/ausbushes/lavendergrass{pixel_x = 12; pixel_y = -21},/obj/structure/flora/ausbushes/lavendergrass{pixel_x = 2; pixel_y = 3},/turf/open/indestructible/ground/inside/mountain,/area/f13/bunker)
"r" = (/obj/effect/overlay/rockfloor_side{icon_state = "rockfloor_side"; dir = 8},/obj/structure/flora/ausbushes/lavendergrass{pixel_x = 2; pixel_y = 3},/turf/open/floor/grass,/area/f13/bunker)
"s" = (/obj/structure/flora/ausbushes/lavendergrass{pixel_x = 2; pixel_y = 3},/turf/open/floor/grass,/area/f13/bunker)
"t" = (/obj/structure/flora/ausbushes/sunnybush,/obj/item/flashlight/spotlight{light_power = 1.5; light_range = 5; name = "cave light"},/turf/open/floor/grass,/area/f13/bunker)
"u" = (/obj/structure/flora/ausbushes/lavendergrass{pixel_x = 5; pixel_y = -9},/turf/open/floor/grass,/area/f13/bunker)
"v" = (/obj/effect/overlay/rockfloor_side{icon_state = "rockfloor_side"; dir = 4},/obj/structure/flora/ausbushes/lavendergrass{pixel_x = 2; pixel_y = 3},/turf/open/floor/grass,/area/f13/bunker)
"w" = (/obj/effect/overlay/rockfloor_side{icon_state = "rockfloor_side"; dir = 8},/obj/effect/overlay/rockfloor_side,/turf/open/floor/grass,/area/f13/bunker)
"x" = (/obj/structure/flora/ausbushes/lavendergrass{pixel_x = 11},/obj/effect/spawner/lootdrop/f13/seedspawner,/turf/open/floor/grass,/area/f13/bunker)
"y" = (/turf/open/floor/grass,/area/f13/bunker)
"z" = (/obj/structure/sink/puddle,/turf/open/floor/grass,/area/f13/bunker)
"A" = (/obj/effect/overlay/rockfloor_side{icon_state = "rockfloor_side"; dir = 4},/obj/structure/flora/ausbushes/lavendergrass{pixel_x = -14},/turf/open/floor/grass,/area/f13/bunker)
"B" = (/obj/effect/overlay/rockfloor_side,/obj/effect/overlay/rockfloor_side{icon_state = "rockfloor_side"; dir = 8},/obj/structure/flora/ausbushes/lavendergrass{pixel_x = 2; pixel_y = 3},/turf/open/floor/grass,/area/f13/bunker)
"C" = (/obj/effect/overlay/rockfloor_side,/obj/structure/flora/ausbushes/lavendergrass{pixel_x = 12; pixel_y = -21},/turf/open/floor/grass,/area/f13/bunker)
"D" = (/obj/effect/overlay/rockfloor_side,/obj/structure/flora/ausbushes/lavendergrass,/turf/open/floor/grass,/area/f13/bunker)
"E" = (/obj/effect/overlay/rockfloor_side,/obj/effect/overlay/rockfloor_side{icon_state = "rockfloor_side"; dir = 4},/obj/effect/spawner/lootdrop/f13/seedspawner,/turf/open/floor/grass,/area/f13/bunker)
"F" = (/obj/structure/closet/crate/miningcar{name = "Mining car"},/turf/open/indestructible/ground/inside/mountain,/area/f13/bunker)
"G" = (/obj/item/t_scanner/adv_mining_scanner/lesser,/turf/open/indestructible/ground/inside/mountain,/area/f13/bunker)
"H" = (/turf/template_noop,/area/template_noop)

(1,1,1) = {"
aaaaaaaaaaHHHHH
aaaaacdccaaaaHH
aaaacecccfaaaaH
aaaccghccccaaaH
aacciccccdcaaaa
aadcccccjcccaaa
acccklmnopcccaa
acccqrstuvcccaa
accccwxyzAcccaa
aaccccBCDEcccaa
aaccdccccccccaa
aaaccccFccccaaa
HaaacGcccccaaaH
HaaaaaccccaaaaH
HHaaaacaaaaaaHH
"}
