"aa" = (/turf/template_noop,/area/template_noop)
"ab" = (/obj/effect/spawner/lootdrop/trash,/obj/machinery/light/small/broken{dir = 1},/turf/open/floor/plasteel/barber{icon_state = "plating"; tag = "icon-plating"},/area/f13/bunker)
"ac" = (/turf/closed/wall/r_wall/rust,/area/f13/bunker)
"ad" = (/obj/effect/decal/waste{icon_state = "goo8"; tag = "icon-goo8"},/turf/open/floor/plasteel/barber{icon_state = "plating"; tag = "icon-plating"},/area/f13/bunker)
"ae" = (/mob/living/simple_animal/hostile/ghoul/glowing,/turf/open/floor/plasteel/barber{icon_state = "platingdmg2"; tag = "icon-platingdmg2"},/area/f13/bunker)
"af" = (/obj/effect/spawner/lootdrop/trash,/turf/open/floor/plasteel/barber{icon = 'icons/turf/f13floors2.dmi'; icon_state = "bluerustychess2"; tag = "icon-bluerustychess2"},/area/f13/bunker)
"ag" = (/obj/structure/chair/stool{dir = 4; icon_state = "bench"; tag = "icon-bench (EAST)"},/obj/machinery/light/small/broken{dir = 1},/turf/open/floor/plasteel/barber{icon = 'icons/turf/f13floors2.dmi'; icon_state = "bluerustychess2"; tag = "icon-bluerustychess2"},/area/f13/bunker)
"ah" = (/obj/structure/chair/stool{dir = 8; icon_state = "bench"; tag = "icon-bench (WEST)"},/turf/open/floor/plasteel/barber{icon = 'icons/turf/f13floors2.dmi'; icon_state = "bluerustychess2"; tag = "icon-bluerustychess2"},/area/f13/bunker)
"ai" = (/turf/open/floor/plasteel/barber{icon = 'icons/turf/f13floors2.dmi'; icon_state = "bluerustychess2"; tag = "icon-bluerustychess2"},/area/f13/bunker)
"aj" = (/obj/structure/reagent_dispensers/barrel/explosive,/turf/open/floor/plasteel/barber{icon_state = "plating"; tag = "icon-plating"},/area/f13/bunker)
"ak" = (/obj/structure/chair/stool,/turf/open/floor/plasteel/barber{icon = 'icons/turf/f13floors2.dmi'; icon_state = "bluerustychess2"; tag = "icon-bluerustychess2"},/area/f13/bunker)
"al" = (/obj/structure/table,/obj/effect/spawner/lootdrop/f13/weapon/melee/random,/turf/open/floor/plasteel/barber{icon = 'icons/turf/f13floors2.dmi'; icon_state = "bluerustychess2"; tag = "icon-bluerustychess2"},/area/f13/bunker)
"am" = (/obj/structure/table,/obj/effect/spawner/lootdrop/f13/traitbooks,/turf/open/floor/plasteel/barber{icon = 'icons/turf/f13floors2.dmi'; icon_state = "bluerustychess2"; tag = "icon-bluerustychess2"},/area/f13/bunker)
"an" = (/obj/structure/chair/stool,/obj/effect/decal/remains/human,/turf/open/floor/plasteel/barber{icon = 'icons/turf/f13floors2.dmi'; icon_state = "bluerustychess2"; tag = "icon-bluerustychess2"},/area/f13/bunker)
"ao" = (/obj/effect/decal/remains/human,/obj/machinery/shower{pixel_y = 32},/turf/open/floor/f13{icon_state = "floorrusty"; tag = "icon-floorrusty"},/area/f13/bunker)
"ap" = (/mob/living/simple_animal/hostile/handy/protectron,/turf/open/floor/f13{icon_state = "floorrusty"; tag = "icon-floorrusty"},/area/f13/bunker)
"aq" = (/obj/structure/table,/obj/machinery/microwave,/turf/open/floor/plasteel/barber{icon = 'icons/turf/f13floors2.dmi'; icon_state = "bluerustychess2"; tag = "icon-bluerustychess2"},/area/f13/bunker)
"ar" = (/obj/effect/spawner/lootdrop/f13/crafting,/turf/open/floor/plasteel/barber{icon = 'icons/turf/f13floors2.dmi'; icon_state = "bluerustychess2"; tag = "icon-bluerustychess2"},/area/f13/bunker)
"as" = (/mob/living/simple_animal/hostile/handy/protectron,/turf/open/floor/plasteel/barber{icon = 'icons/turf/f13floors2.dmi'; icon_state = "bluerustychess2"; tag = "icon-bluerustychess2"},/area/f13/bunker)
"at" = (/obj/structure/simple_door/bunker,/turf/open/floor/plasteel/barber{icon = 'icons/turf/f13floors2.dmi'; icon_state = "bluerustychess2"; tag = "icon-bluerustychess2"},/area/f13/bunker)
"au" = (/turf/open/floor/f13{icon_state = "floorrusty"; tag = "icon-floorrusty"},/area/f13/bunker)
"av" = (/obj/effect/decal/remains/human,/obj/item/clothing/suit/radiation,/obj/item/clothing/head/radiation,/turf/open/floor/f13{icon_state = "floorrusty"; tag = "icon-floorrusty"},/area/f13/bunker)
"aw" = (/obj/structure/table,/obj/item/kitchen/knife,/turf/open/floor/plasteel/barber{icon = 'icons/turf/f13floors2.dmi'; icon_state = "bluerustychess2"; tag = "icon-bluerustychess2"},/area/f13/bunker)
"ax" = (/obj/structure/grille,/obj/structure/window/reinforced/fulltile,/obj/machinery/door/poddoor{id = 4},/turf/open/floor/f13{icon_state = "darkredfull"; tag = "icon-darkredfull"},/area/f13/bunker)
"ay" = (/obj/structure/closet/fridge,/obj/effect/spawner/lootdrop/f13/foodspawner,/obj/effect/spawner/lootdrop/f13/foodspawner,/obj/effect/spawner/lootdrop/f13/foodspawner,/turf/open/floor/plasteel/barber{icon = 'icons/turf/f13floors2.dmi'; icon_state = "bluerustychess2"; tag = "icon-bluerustychess2"},/area/f13/bunker)
"az" = (/obj/structure/closet/crate/bin,/obj/item/storage/trash_stack,/turf/open/floor/plasteel/barber{icon = 'icons/turf/f13floors2.dmi'; icon_state = "bluerustychess2"; tag = "icon-bluerustychess2"},/area/f13/bunker)
"aA" = (/obj/effect/decal/remains/human,/turf/open/floor/plasteel/barber{icon = 'icons/turf/f13floors2.dmi'; icon_state = "bluerustychess2"; tag = "icon-bluerustychess2"},/area/f13/bunker)
"aB" = (/obj/effect/mine/stun,/turf/open/floor/f13{icon_state = "darkredfull"; tag = "icon-darkredfull"},/area/f13/bunker)
"aC" = (/turf/open/floor/f13{icon_state = "darkredfull"; tag = "icon-darkredfull"},/area/f13/bunker)
"aD" = (/obj/effect/spawner/lootdrop/trash,/turf/open/floor/f13{icon_state = "darkredfull"; tag = "icon-darkredfull"},/area/f13/bunker)
"aE" = (/obj/machinery/button{id = 4; pixel_y = 32},/turf/open/floor/f13{icon_state = "darkredfull"; tag = "icon-darkredfull"},/area/f13/bunker)
"aF" = (/obj/structure/filingcabinet,/turf/open/floor/f13{icon_state = "darkredfull"; tag = "icon-darkredfull"},/area/f13/bunker)
"aG" = (/obj/structure/simple_door/bunker,/turf/open/floor/f13{icon_state = "whitegreenrustychess"},/area/f13/bunker)
"aH" = (/obj/structure/reagent_dispensers/barrel/two,/turf/open/floor/plasteel/barber{icon_state = "platingdmg2"; tag = "icon-platingdmg2"},/area/f13/bunker)
"aI" = (/obj/item/paper_bin{pixel_y = 6},/obj/item/pen{pixel_y = 9},/obj/item/phone,/obj/structure/table,/turf/open/floor/f13{icon_state = "darkredfull"; tag = "icon-darkredfull"},/area/f13/bunker)
"aJ" = (/obj/structure/chair/office{dir = 1; icon_state = "chair"; tag = "icon-chair (NORTH)"},/turf/open/floor/f13{icon_state = "darkredfull"; tag = "icon-darkredfull"},/area/f13/bunker)
"aK" = (/obj/effect/spawner/lootdrop/f13/alcoholspawner,/obj/machinery/light/small/broken{dir = 1},/turf/open/floor/f13{icon_state = "whitegreenrustychess"},/area/f13/bunker)
"aL" = (/obj/structure/toilet{pixel_y = 13},/turf/open/floor/f13{icon_state = "whitegreenrustychess"},/area/f13/bunker)
"aM" = (/turf/open/floor/f13{icon_state = "whitegreenrustychess"},/area/f13/bunker)
"aN" = (/obj/structure/closet/crate/bin,/turf/open/floor/f13{icon_state = "whitegreenrustychess"},/area/f13/bunker)
"aO" = (/turf/open/floor/plasteel/barber{icon_state = "plating"; tag = "icon-plating"},/area/f13/bunker)
"aP" = (/obj/effect/decal/waste{icon_state = "goo10"; tag = "icon-goo10"},/obj/effect/spawner/lootdrop/f13/advcrafting,/obj/effect/spawner/lootdrop/f13/advcrafting,/turf/open/floor/plasteel/barber{icon_state = "plating"; tag = "icon-plating"},/area/f13/bunker)
"aQ" = (/obj/effect/spawner/lootdrop/trash,/turf/open/floor/plasteel/barber{icon_state = "plating"; tag = "icon-plating"},/area/f13/bunker)
"aR" = (/obj/structure/reagent_dispensers/barrel/four,/turf/open/floor/plasteel/barber{icon_state = "plating"; tag = "icon-plating"},/area/f13/bunker)
"aS" = (/obj/machinery/shower{dir = 4; icon_state = "shower"; tag = "icon-shower (EAST)"},/obj/item/clothing/head/helmet/f13/tribal,/turf/open/floor/f13{icon_state = "whitegreenrustychess"},/area/f13/bunker)
"aT" = (/mob/living/simple_animal/hostile/ghoul/reaver,/turf/open/floor/f13{icon_state = "whitegreenrustychess"},/area/f13/bunker)
"aU" = (/obj/structure/sink{dir = 4; icon_state = "sink"; pixel_x = 10; pixel_y = 0; tag = "icon-sink (EAST)"},/obj/structure/mirror{pixel_x = 32},/turf/open/floor/f13{icon_state = "whitegreenrustychess"},/area/f13/bunker)
"aV" = (/obj/effect/spawner/lootdrop/f13/weapon/gun/random,/turf/open/floor/plasteel/barber{icon_state = "plating"; tag = "icon-plating"},/area/f13/bunker)
"aW" = (/mob/living/simple_animal/hostile/ghoul/glowing,/turf/open/floor/plasteel/barber{icon_state = "plating"; tag = "icon-plating"},/area/f13/bunker)
"aX" = (/obj/effect/decal/waste{icon_state = "goo12"; tag = "icon-goo12"},/obj/structure/reagent_dispensers/barrel/three,/turf/open/floor/plasteel/barber{icon_state = "plating"; tag = "icon-plating"},/area/f13/bunker)
"aY" = (/obj/structure/closet/crate/secure/weapon,/obj/effect/spawner/lootdrop/f13/armor/random_high,/turf/open/floor/f13{icon_state = "darkredfull"; tag = "icon-darkredfull"},/area/f13/bunker)
"aZ" = (/obj/structure/closet/crate/secure/weapon,/obj/effect/spawner/lootdrop/f13/weapon/gun/tier3,/obj/machinery/light/small/broken{dir = 1},/turf/open/floor/f13{icon_state = "darkredfull"; tag = "icon-darkredfull"},/area/f13/bunker)
"ba" = (/obj/structure/simple_door/bunker,/turf/open/floor/f13{icon_state = "darkredfull"; tag = "icon-darkredfull"},/area/f13/bunker)
"bb" = (/obj/effect/decal/remains/human,/obj/item/clothing/suit/radiation,/obj/item/clothing/head/radiation,/turf/open/floor/plasteel/barber{icon_state = "platingdmg1"; tag = "icon-platingdmg1"},/area/f13/bunker)
"bc" = (/obj/structure/reagent_dispensers/barrel/explosive,/turf/open/floor/plasteel/barber{icon_state = "platingdmg1"; tag = "icon-platingdmg1"},/area/f13/bunker)
"bd" = (/obj/structure/rack,/obj/effect/spawner/lootdrop/f13/weapon/gun/random,/turf/open/floor/f13{icon_state = "darkredfull"; tag = "icon-darkredfull"},/area/f13/bunker)
"be" = (/obj/item/storage/trash_stack,/obj/effect/spawner/lootdrop/clothing_high,/turf/open/floor/f13{icon_state = "darkredfull"; tag = "icon-darkredfull"},/area/f13/bunker)
"bl" = (/turf/open/floor/plasteel/barber{icon_state = "platingdmg3"; tag = "icon-platingdmg3"},/area/f13/bunker)
"bm" = (/mob/living/simple_animal/hostile/ghoul/glowing,/turf/open/floor/plasteel/barber{icon_state = "platingdmg3"; tag = "icon-platingdmg3"},/area/f13/bunker)
"bn" = (/turf/open/floor/plasteel/barber{icon_state = "platingdmg2"; tag = "icon-platingdmg2"},/area/f13/bunker)
"bo" = (/obj/item/stack/f13Cash/random/bottle_cap/med,/turf/open/floor/f13{icon_state = "darkredfull"; tag = "icon-darkredfull"},/area/f13/bunker)
"bq" = (/mob/living/simple_animal/hostile/handy/gutsy,/turf/open/floor/f13{icon_state = "darkredfull"; tag = "icon-darkredfull"},/area/f13/bunker)
"bt" = (/obj/structure/closet,/obj/item/clothing/gloves/combat,/obj/item/clothing/shoes/combat,/obj/effect/spawner/lootdrop/clothing_high,/turf/open/floor/f13{icon_state = "darkredfull"; tag = "icon-darkredfull"},/area/f13/bunker)
"bu" = (/obj/structure/closet,/obj/item/clothing/gloves/combat,/obj/item/clothing/shoes/combat,/obj/effect/spawner/lootdrop/f13/armor/random_high,/obj/machinery/light/small/broken,/turf/open/floor/f13{icon_state = "darkredfull"; tag = "icon-darkredfull"},/area/f13/bunker)

(1,1,1) = {"
aaaaacacacacacacaaaaaaaaaaaaaa
aaaaacafagahaiacacacacacacaaaa
acacacakalamanacacaoapaoacaaaa
acaqaiarasafaiaiatauavauataaaa
acawaiaiaiaiaiacacaxaxaxacacac
acayaiafazaAaiataBaCaCaDaEaFac
acacaGacacatacacacacaIaJaCaDac
aKaLaMaNacaOabadbnacacacacaCac
aSaTaUacacblaeajacacaYaZacbaac
acacacacbbaOblaOacbdaCaCacbeac
acaHaPbnaOaQaOaRacbdaCaCbaaDac
aaaaaOaVblbmbnbnacacboaCacacac
aaaaaaaaaaaOaOaWaOacbqaDacaaaa
aaaaaaaaaaaabnaXbcacbtbuacaaaa
aaaaaaaaaaaabnacacacacacacaaaa
"}
