"aa" = (/turf/open/indestructible/ground/desert,/area/f13/wasteland)
"ab" = (/turf/open/floor/f13/wood,/area/f13/wasteland)
"ac" = (/turf/closed/wall/f13/wood/house/broken,/area/f13/wasteland)
"ad" = (/turf/open/indestructible/ground/sidewalk{dir = 8; icon_state = "outerpavementcorner"},/area/f13/wasteland)
"ae" = (/turf/open/indestructible/ground/sidewalk{icon_state = "outermaincornerouter"},/area/f13/wasteland)
"af" = (/turf/open/indestructible/ground/sidewalk{dir = 8; icon_state = "outermaincornerouter"},/area/f13/wasteland)
"ag" = (/obj/structure/tires,/turf/open/indestructible/ground/desert,/area/f13/wasteland)
"ah" = (/obj/structure/flora/tree/wasteland,/turf/open/indestructible/ground/desert,/area/f13/wasteland)
"ai" = (/turf/open/indestructible/ground/sidewalk{dir = 2; icon_state = "outerpavementcorner"},/area/f13/wasteland)
"aj" = (/obj/item/weapon/bikehorn,/turf/open/floor/f13/wood,/area/f13/wasteland)
"ak" = (/turf/open/indestructible/ground/sidewalk{dir = 8; icon_state = "outerpavement"},/area/f13/wasteland)
"al" = (/turf/open/indestructible/ground/sidewalk{dir = 4; icon_state = "outermaincornerouter"},/area/f13/wasteland)
"am" = (/turf/open/indestructible/ground/sidewalk{dir = 1; icon_state = "outermaincornerouter"},/area/f13/wasteland)
"an" = (/turf/open/indestructible/ground/sidewalk{dir = 2; icon_state = "outerpavement"},/area/f13/wasteland)
"ao" = (/turf/open/indestructible/ground/sidewalk{dir = 6; icon_state = "outerpavement"},/area/f13/wasteland)
"ap" = (/turf/closed/wall/f13/wood/house,/area/f13/wasteland)
"aq" = (/obj/structure/table/wood/settler,/obj/item/key/motorcycle,/turf/open/floor/f13/wood,/area/f13/wasteland)
"ar" = (/turf/open/indestructible/ground/sidewalk{dir = 10; icon_state = "outerpavement"},/area/f13/wasteland)
"as" = (/turf/open/indestructible/ground/sidewalk{dir = 4; icon_state = "outerpavement"},/area/f13/wasteland)
"at" = (/turf/closed/wall/f13/supermart{desc = "Remove kebab."; name = "kebab outpost wall"},/area/f13/secret)
"au" = (/turf/closed/wall/f13/supermart{desc = "Remove kebab."; icon_state = "storeprewindowleft"; name = "kebab outpost wall"},/area/f13/secret)
"av" = (/obj/structure/window/fulltile/store{icon_state = "storewindowleft"},/turf/open/floor/f13{icon_state = "floordirtysolid"},/area/f13/secret)
"aw" = (/obj/structure/window/fulltile/store,/turf/open/floor/f13{icon_state = "floordirtysolid"},/area/f13/secret)
"ax" = (/obj/structure/window/fulltile/store{icon_state = "storewindowright"},/turf/open/floor/f13{icon_state = "floordirtysolid"},/area/f13/secret)
"ay" = (/turf/closed/wall/f13/supermart{desc = "Remove kebab."; icon_state = "storeprewindowright"; name = "kebab outpost wall"},/area/f13/secret)
"az" = (/turf/closed/wall/f13/wood/house,/area/f13/building)
"aA" = (/obj/structure/simple_door/brokenglass,/obj/structure/decoration/rag,/turf/open/floor/f13/wood,/area/f13/building)
"aB" = (/turf/closed/wall/f13/supermart{desc = "Remove kebab."; icon_state = "storeprewindowtop"; name = "kebab outpost wall"},/area/f13/secret)
"aC" = (/obj/machinery/light{dir = 1},/obj/structure/closet/cabinet,/obj/item/weapon/reagent_containers/food/drinks/bottle/nukacola,/obj/item/weapon/reagent_containers/food/drinks/bottle/nukacola,/obj/item/weapon/reagent_containers/food/drinks/bottle/nukacola,/obj/item/weapon/reagent_containers/food/drinks/bottle/nukacola,/obj/item/weapon/reagent_containers/food/drinks/bottle/sunset,/obj/item/weapon/reagent_containers/food/drinks/bottle/sunset,/obj/item/weapon/reagent_containers/food/drinks/bottle/sunset,/obj/item/weapon/reagent_containers/food/drinks/bottle/sunset,/obj/item/weapon/reagent_containers/food/drinks/bottle/sunset,/obj/item/weapon/reagent_containers/food/drinks/bottle/sunset,/obj/item/weapon/reagent_containers/food/drinks/bottle/sunset,/obj/item/weapon/reagent_containers/food/drinks/bottle/whiskey,/obj/item/weapon/reagent_containers/food/drinks/bottle/vodka,/obj/item/weapon/reagent_containers/food/drinks/bottle/rum,/obj/item/weapon/storage/box/drinkingglasses,/obj/item/weapon/reagent_containers/food/snacks/f13/mechanic,/obj/item/weapon/reagent_containers/food/snacks/f13/mechanic,/turf/open/floor/f13{icon_state = "floorrusty"},/area/f13/secret)
"aD" = (/turf/open/floor/f13{icon_state = "floorrusty"},/area/f13/secret)
"aE" = (/obj/machinery/light{dir = 1},/obj/structure/closet/crate/bin,/turf/open/floor/f13{icon_state = "floorrusty"},/area/f13/secret)
"aF" = (/obj/structure/mopbucket,/turf/open/floor/f13{icon_state = "bluedirtychess2"},/area/f13/secret)
"aG" = (/obj/machinery/light/small{dir = 1},/obj/item/weapon/mop,/turf/open/floor/f13{icon_state = "bluerustychess2"},/area/f13/secret)
"aH" = (/obj/structure/toilet,/turf/open/floor/f13{icon_state = "bluedirtychess2"},/area/f13/secret)
"aI" = (/obj/structure/bookcase/random/fiction,/turf/open/floor/f13/wood,/area/f13/building)
"aJ" = (/obj/structure/table/wood/settler,/turf/open/floor/f13/wood,/area/f13/building)
"aK" = (/obj/structure/closet/cabinet,/obj/item/clothing/shoes/f13/swimfins,/obj/item/clothing/under/f13/settler,/obj/item/weapon/reagent_containers/food/snacks/f13/porknbeans,/obj/item/weapon/reagent_containers/food/drinks/flask/survival,/turf/open/floor/f13/wood,/area/f13/building)
"aL" = (/turf/open/floor/f13/wood,/area/f13/building)
"aM" = (/obj/machinery/light/small{dir = 1},/turf/open/floor/f13/wood,/area/f13/building)
"aN" = (/obj/structure/decoration/clock/old/active{pixel_y = 32},/turf/open/floor/f13/wood,/area/f13/building)
"aO" = (/obj/structure/table,/turf/open/floor/f13/wood,/area/f13/building)
"aP" = (/obj/structure/window/fulltile/store{icon_state = "storewindowtop"},/turf/open/floor/f13{icon_state = "floordirtysolid"},/area/f13/secret)
"aQ" = (/turf/open/floor/f13{icon_state = "floordirty"},/area/f13/secret)
"aR" = (/obj/structure/table/wood/bar,/obj/item/weapon/lighter,/turf/open/floor/f13{icon_state = "floorrusty"},/area/f13/secret)
"aS" = (/obj/structure/simple_door/room,/turf/open/floor/f13{icon_state = "bluedirtychess2"},/area/f13/secret)
"aT" = (/turf/open/floor/f13{icon_state = "bluedirtychess2"},/area/f13/secret)
"aU" = (/obj/item/trash/deadmouse,/turf/open/floor/f13{icon_state = "bluerustychess2"},/area/f13/secret)
"aV" = (/obj/structure/window/fulltile/store{icon_state = "storewindowvertical"},/turf/open/floor/f13{icon_state = "floordirtysolid"},/area/f13/secret)
"aW" = (/obj/structure/table/wood/bar,/obj/item/weapon/reagent_containers/food/drinks/bottle/sunset{pixel_y = 4},/turf/open/floor/f13{icon_state = "floordirty"},/area/f13/secret)
"aX" = (/obj/structure/table/wood/bar,/obj/item/weapon/reagent_containers/glass/rag{pixel_y = 7},/turf/open/floor/f13{icon_state = "floordirty"},/area/f13/secret)
"aY" = (/obj/structure/table/wood/bar,/turf/open/floor/f13{icon_state = "floordirty"},/area/f13/secret)
"aZ" = (/obj/structure/table/wood/bar,/obj/item/weapon/reagent_containers/food/drinks/bottle/nukacola{pixel_y = 5},/turf/open/floor/f13{icon_state = "floordirty"},/area/f13/secret)
"ba" = (/obj/structure/table,/obj/item/weapon/storage/box/lights/mixed,/turf/open/floor/f13{icon_state = "bluerustychess2"},/area/f13/secret)
"bb" = (/obj/structure/sink{dir = 4; pixel_x = 14; pixel_y = 5},/obj/structure/mirror{pixel_x = 28},/turf/open/floor/f13{icon_state = "bluedirtychess2"},/area/f13/secret)
"bc" = (/obj/structure/chair/comfy/brown{dir = 4},/turf/open/floor/f13/wood,/area/f13/building)
"bd" = (/obj/structure/easel,/turf/open/floor/f13/wood,/area/f13/building)
"be" = (/obj/structure/chair/wood{dir = 4},/turf/open/floor/f13/wood,/area/f13/building)
"bf" = (/obj/structure/table/wood/settler,/obj/item/weapon/reagent_containers/food/snacks/f13/galette,/turf/open/floor/f13/wood,/area/f13/building)
"bg" = (/obj/structure/chair/wood{dir = 8},/turf/open/floor/f13/wood,/area/f13/building)
"bh" = (/obj/structure/window/fulltile/store{icon_state = "storewindowbottom"},/turf/open/floor/f13{icon_state = "floordirtysolid"},/area/f13/secret)
"bi" = (/obj/structure/chair/stool/bar,/turf/open/floor/f13{icon_state = "floorrusty"},/area/f13/secret)
"bj" = (/obj/structure/chair/stool/bar,/turf/open/floor/f13{icon_state = "floordirty"},/area/f13/secret)
"bk" = (/obj/structure/table/wood/settler,/obj/item/weapon/book/manual/random{pixel_y = 2},/turf/open/floor/f13/wood,/area/f13/building)
"bl" = (/obj/structure/table/wood/settler,/obj/item/trash/candle{pixel_y = 4},/turf/open/floor/f13/wood,/area/f13/building)
"bm" = (/turf/closed/wall/f13/supermart{desc = "Remove kebab."; icon_state = "storeprewindowbottom"; name = "kebab outpost wall"},/area/f13/secret)
"bn" = (/obj/machinery/light{dir = 8},/turf/open/floor/f13{icon_state = "floorrusty"},/area/f13/secret)
"bo" = (/obj/machinery/light{dir = 4},/turf/open/floor/f13{icon_state = "floorrusty"},/area/f13/secret)
"bp" = (/obj/structure/rack,/turf/open/floor/f13{icon_state = "floorrusty"},/area/f13/secret)
"bq" = (/obj/structure/closet/cabinet,/obj/item/clothing/shoes/laceup,/obj/item/clothing/under/f13/bartenderalt,/obj/item/clothing/head/f13/fez,/turf/open/floor/f13{icon_state = "floordirty"},/area/f13/secret)
"br" = (/obj/structure/tires/half,/turf/open/indestructible/ground/desert,/area/f13/wasteland)
"bs" = (/obj/machinery/light/small,/turf/open/floor/f13/wood,/area/f13/building)
"bt" = (/obj/structure/fence,/turf/open/indestructible/ground/sidewalk{dir = 8; icon_state = "outerpavement"},/area/f13/wasteland)
"bu" = (/obj/structure/fence/door,/turf/open/indestructible/ground/desert,/area/f13/wasteland)
"bv" = (/obj/structure/fence,/turf/open/indestructible/ground/sidewalk{dir = 4; icon_state = "outerpavement"},/area/f13/wasteland)
"bw" = (/obj/structure/piano/pristine,/turf/open/floor/f13{icon_state = "floorrusty"},/area/f13/secret)
"bx" = (/obj/structure/chair/wood/modern{dir = 8},/turf/open/floor/f13{icon_state = "floordirty"},/area/f13/secret)
"by" = (/obj/item/weapon/paper/crumpled{info = "<h2>KEBAB</h2><br><b>Kebab:</b> <i>100 kebab</i><br><b>Kebab Kebab:</b> <i>200 kebab</i><br><b>Remove Kebab:</b> <i>50 kebab</i>"; name = "paper of kebab"},/turf/open/floor/f13{icon_state = "floorrusty"},/area/f13/secret)
"bz" = (/obj/structure/simple_door/glass,/turf/open/floor/f13{icon_state = "floordirty"},/area/f13/secret)
"bA" = (/obj/machinery/light/small{dir = 4},/turf/open/floor/f13{icon_state = "floordirty"},/area/f13/secret)
"bB" = (/obj/structure/window/fulltile/house/broken,/obj/structure/decoration/rag,/turf/open/floor/f13/wood,/area/f13/building)
"bC" = (/obj/structure/simple_door/house,/turf/open/floor/f13/wood,/area/f13/building)
"bD" = (/obj/structure/window/fulltile/house,/turf/open/floor/f13/wood,/area/f13/building)
"bE" = (/obj/structure/chair/comfy/brown,/turf/open/floor/f13{icon_state = "floorrusty"},/area/f13/secret)
"bF" = (/obj/item/clothing/mask/cigarette,/turf/open/floor/f13{icon_state = "floorrusty"},/area/f13/secret)
"bG" = (/obj/structure/table/wood,/obj/item/clothing/suit/armor/f13/kit,/turf/open/floor/f13{icon_state = "floorrusty"},/area/f13/secret)
"bH" = (/obj/structure/table/wood,/obj/item/weapon/book/manual/barman_recipes{pixel_y = 3},/turf/open/floor/f13{icon_state = "floorrusty"},/area/f13/secret)
"bI" = (/turf/open/indestructible/ground/sidewalk{dir = 4; icon_state = "outerpavementcorner"},/area/f13/wasteland)
"bJ" = (/turf/open/indestructible/ground/sidewalk{dir = 1; icon_state = "outerpavement"},/area/f13/wasteland)
"bK" = (/turf/open/indestructible/ground/sidewalk{dir = 5; icon_state = "outerpavement"},/area/f13/wasteland)
"bL" = (/turf/open/indestructible/ground/sidewalk,/area/f13/wasteland)
"bM" = (/turf/open/indestructible/ground/sidewalk{dir = 9; icon_state = "outerpavement"},/area/f13/wasteland)
"bN" = (/turf/open/indestructible/ground/sidewalk{dir = 1; icon_state = "outerpavementcorner"},/area/f13/wasteland)
"bO" = (/obj/machinery/light{dir = 8},/obj/structure/table/wood,/obj/item/weapon/reagent_containers/food/condiment/saltshaker{pixel_x = 10},/obj/item/weapon/reagent_containers/food/condiment/peppermill,/turf/open/floor/f13{icon_state = "floorrusty"},/area/f13/secret)
"bP" = (/obj/structure/table/wood,/obj/item/weapon/reagent_containers/food/snacks/kebab/tail{name = "lizard kebab"; pixel_y = 5},/turf/open/floor/f13{icon_state = "floordirty"},/area/f13/secret)
"bQ" = (/obj/machinery/light{dir = 4},/obj/structure/table/wood,/obj/item/weapon/reagent_containers/food/drinks/bottle/sunset{pixel_y = 4},/turf/open/floor/f13{icon_state = "floorrusty"},/area/f13/secret)
"bR" = (/obj/machinery/light/small{dir = 4},/turf/open/floor/f13{icon_state = "floorrusty"},/area/f13/secret)
"bS" = (/obj/structure/chair/comfy/brown{dir = 1},/turf/open/floor/f13{icon_state = "floorrusty"},/area/f13/secret)
"bT" = (/obj/structure/chair/wood/modern{dir = 1},/turf/open/floor/f13{icon_state = "floorrusty"},/area/f13/secret)
"bU" = (/obj/structure/bed,/obj/item/weapon/bedsheet/red,/turf/open/floor/f13{icon_state = "floordirty"},/area/f13/secret)
"bV" = (/obj/structure/table/wood,/obj/item/device/harmonica{pixel_y = 4},/turf/open/floor/f13{icon_state = "floordirty"},/area/f13/secret)
"bW" = (/obj/structure/bed,/obj/item/weapon/bedsheet/yellow,/turf/open/floor/f13{icon_state = "floordirty"},/area/f13/secret)
"bX" = (/obj/structure/simple_door/room,/turf/open/floor/f13{icon_state = "floorrustysolid"},/area/f13/secret)
"bY" = (/turf/open/indestructible/ground/sidewalk{icon_state = "tinycornerhorizontal"},/area/f13/wasteland)
"bZ" = (/turf/open/indestructible/ground/sidewalk{icon_state = "horizontaltopbordertop2left"},/area/f13/wasteland)
"ca" = (/turf/open/indestructible/ground/sidewalk{icon_state = "horizontaltopbordertop2"},/area/f13/wasteland)
"cb" = (/turf/open/indestructible/ground/sidewalk{icon_state = "horizontaltopbordertop3"},/area/f13/wasteland)
"cc" = (/turf/open/indestructible/ground/sidewalk{icon_state = "horizontaltopbordertop2right"},/area/f13/wasteland)
"cd" = (/turf/open/indestructible/ground/sidewalk{icon_state = "horizontaltopbordertop0"},/area/f13/wasteland)
"ce" = (/turf/open/indestructible/ground/sidewalk{icon_state = "horizontaltopbordertop1"},/area/f13/wasteland)
"cf" = (/turf/open/indestructible/ground/sidewalk{dir = 8; icon_state = "tinycornerhorizontal"},/area/f13/wasteland)
"cg" = (/obj/machinery/light/small/red{dir = 4},/turf/open/indestructible/ground/sidewalk,/area/f13/wasteland)
"ch" = (/obj/machinery/vending/nukacolavend,/turf/open/floor/f13/wood,/area/f13/secret)
"ci" = (/obj/structure/decoration/sign{desc = "Remove kebab."; icon_state = "vault_kebab"; name = "kebab sign"; pixel_x = -10; pixel_y = 28},/turf/open/floor/f13/wood,/area/f13/secret)
"cj" = (/turf/open/floor/f13/wood,/area/f13/secret)
"ck" = (/obj/machinery/light/small{dir = 1},/turf/open/floor/f13/wood,/area/f13/secret)
"cl" = (/obj/structure/filingcabinet/chestdrawer,/turf/open/floor/f13/wood,/area/f13/secret)
"cm" = (/obj/machinery/light/small/red{dir = 8},/turf/open/indestructible/ground/sidewalk{dir = 9; icon_state = "outerpavement"},/area/f13/secret)
"cn" = (/turf/open/indestructible/ground/sidewalk{icon_state = "tinycornervertical"},/area/f13/wasteland)
"co" = (/turf/open/indestructible/ground/road{dir = 1; icon_state = "innerturn"},/area/f13/wasteland)
"cp" = (/turf/open/indestructible/ground/road{icon_state = "horizontaltopborderbottom1"},/area/f13/wasteland)
"cq" = (/turf/open/indestructible/ground/road{icon_state = "horizontaltopborderbottom2"},/area/f13/wasteland)
"cr" = (/obj/vehicle/fuel/motorcycle/rusty{dir = 4},/turf/open/indestructible/ground/road{icon_state = "horizontaltopborderbottom0"},/area/f13/wasteland)
"cs" = (/turf/open/indestructible/ground/road{icon_state = "horizontaltopborderbottom0"},/area/f13/wasteland)
"ct" = (/turf/open/indestructible/ground/road{dir = 4; icon_state = "innerturn"},/area/f13/wasteland)
"cu" = (/turf/open/indestructible/ground/sidewalk{dir = 8; icon_state = "tinycornervertical"},/area/f13/wasteland)
"cv" = (/obj/structure/table/wood,/turf/open/floor/f13/wood,/area/f13/secret)
"cw" = (/obj/structure/table/wood,/obj/item/weapon/phone,/turf/open/floor/f13/wood,/area/f13/secret)
"cx" = (/turf/open/indestructible/ground/sidewalk{dir = 8; icon_state = "outerpavement"},/area/f13/secret)
"cy" = (/turf/open/indestructible/ground/sidewalk{icon_state = "verticalleftborderleft1"},/area/f13/wasteland)
"cz" = (/turf/open/indestructible/ground/road,/area/f13/wasteland)
"cA" = (/turf/open/indestructible/ground/road{icon_state = "verticalinnermain1"},/area/f13/wasteland)
"cB" = (/turf/open/indestructible/ground/sidewalk{icon_state = "verticalrightborderright0"},/area/f13/wasteland)
"cC" = (/obj/structure/simple_door/metal/store,/turf/open/floor/f13/wood,/area/f13/secret)
"cD" = (/obj/structure/table/wood,/obj/item/toy/redbutton,/turf/open/floor/f13/wood,/area/f13/secret)
"cE" = (/obj/structure/chair/wood/worn{dir = 8},/turf/open/floor/f13/wood,/area/f13/secret)
"cF" = (/obj/structure/decoration/hatch{dir = 8; icon_state = "hatchbroken"},/turf/open/indestructible/ground/road{icon_state = "verticalleftborderright0"},/area/f13/wasteland)
"cG" = (/turf/open/indestructible/ground/road{icon_state = "verticalinnermain0"},/area/f13/wasteland)
"cH" = (/turf/open/indestructible/ground/road{icon_state = "hole"},/area/f13/wasteland)
"cI" = (/obj/structure/decoration/hatch{dir = 4},/turf/open/indestructible/ground/road{icon_state = "verticalrightborderleft1"},/area/f13/wasteland)
"cJ" = (/obj/structure/chair/stool,/turf/open/floor/f13/wood,/area/f13/secret)
"cK" = (/turf/open/indestructible/ground/sidewalk{icon_state = "verticalleftborderleft0"},/area/f13/wasteland)
"cL" = (/turf/open/indestructible/ground/road{icon_state = "verticalleftborderright0"},/area/f13/wasteland)
"cM" = (/turf/open/indestructible/ground/road{icon_state = "verticalinnermain2"},/area/f13/wasteland)
"cN" = (/turf/open/indestructible/ground/road{icon_state = "innermaincornerinner"},/area/f13/wasteland)
"cO" = (/turf/open/indestructible/ground/road{dir = 8; icon_state = "innermaincornerinner"},/area/f13/wasteland)
"cP" = (/turf/open/indestructible/ground/road{icon_state = "verticalrightborderleft0"},/area/f13/wasteland)
"cQ" = (/turf/open/indestructible/ground/sidewalk{icon_state = "verticalrightborderright1"},/area/f13/wasteland)
"cR" = (/obj/structure/closet/crate/bin,/turf/open/floor/f13/wood,/area/f13/secret)
"cS" = (/obj/machinery/light/small,/turf/open/floor/f13/wood,/area/f13/secret)
"cT" = (/obj/structure/table,/obj/item/clothing/head/helmet/f13/eyebot,/turf/open/floor/f13/wood,/area/f13/secret)
"cU" = (/obj/machinery/light/small/red{dir = 8},/turf/open/indestructible/ground/sidewalk{dir = 10; icon_state = "outerpavement"},/area/f13/secret)
"cV" = (/turf/open/indestructible/ground/road{icon_state = "verticalinnermainbottom"},/area/f13/wasteland)
"cW" = (/turf/open/indestructible/ground/road{dir = 1; icon_state = "innermaincornerouter"},/area/f13/wasteland)
"cX" = (/turf/open/indestructible/ground/road{dir = 4; icon_state = "innermaincornerouter"},/area/f13/wasteland)
"cY" = (/obj/machinery/light/street{dir = 1; pixel_x = -32},/turf/open/indestructible/ground/sidewalk{dir = 8; icon_state = "outerpavement"},/area/f13/wasteland)
"cZ" = (/turf/open/indestructible/ground/road{dir = 4; icon_state = "innermaincornerinner"},/area/f13/wasteland)
"da" = (/turf/open/indestructible/ground/road{dir = 8; icon_state = "innermaincornerouter"},/area/f13/wasteland)
"db" = (/turf/open/indestructible/ground/road{icon_state = "horizontalinnermainleft"},/area/f13/wasteland)
"dc" = (/obj/structure/table/wood/classic,/obj/item/weapon/storage/pill_bottle/dice,/turf/open/floor/f13{icon_state = "floordirty"},/area/f13/secret)
"dd" = (/obj/structure/bookcase/random/fiction,/turf/open/floor/f13{icon_state = "floordirty"},/area/f13/secret)
"de" = (/obj/structure/bookcase/manuals/medical,/turf/open/floor/f13{icon_state = "floorrusty"},/area/f13/secret)
"df" = (/obj/structure/rack,/turf/open/floor/f13{icon_state = "floordirty"},/area/f13/secret)
"dg" = (/obj/structure/mirror{pixel_y = 26},/obj/structure/dresser,/turf/open/floor/f13{icon_state = "floorrusty"},/area/f13/secret)
"dh" = (/obj/structure/bed,/obj/item/weapon/bedsheet/brown,/turf/open/floor/f13{icon_state = "floordirty"},/area/f13/secret)
"di" = (/obj/structure/table/wood/classic,/obj/item/weapon/holodisk/musicbox,/turf/open/floor/f13{icon_state = "floordirty"},/area/f13/secret)
"dj" = (/obj/structure/closet/cabinet,/obj/item/weapon/lipstick/black,/obj/item/weapon/reagent_containers/food/drinks/bottle/cognac,/obj/item/clothing/under/female/plaid_skirt,/obj/item/clothing/under/f13/female/merccharm,/obj/item/clothing/shoes/f13/military/female/diesel,/obj/item/clothing/under/female/blacktango,/turf/open/floor/f13{icon_state = "floorrusty"},/area/f13/secret)
"dk" = (/turf/open/indestructible/ground/road{dir = 2; icon_state = "innermaincornerouter"},/area/f13/wasteland)
"dl" = (/turf/open/indestructible/ground/road{dir = 1; icon_state = "innermaincornerinner"},/area/f13/wasteland)
"dm" = (/turf/open/indestructible/ground/road{icon_state = "verticalrightborderleft1"},/area/f13/wasteland)
"dn" = (/obj/machinery/light{dir = 4},/turf/open/floor/f13{icon_state = "floordirty"},/area/f13/secret)
"do" = (/turf/open/indestructible/ground/sidewalk{dir = 4; icon_state = "outerbordercorner"},/area/f13/wasteland)
"dp" = (/turf/open/indestructible/ground/sidewalk{dir = 4; icon_state = "outerturn"},/area/f13/wasteland)
"dq" = (/turf/open/indestructible/ground/sidewalk{dir = 1; icon_state = "outerturn"},/area/f13/wasteland)
"dr" = (/turf/open/indestructible/ground/sidewalk{dir = 1; icon_state = "outerbordercorner"},/area/f13/wasteland)
"ds" = (/obj/structure/chair/comfy/black,/turf/open/floor/f13{icon_state = "floorrusty"},/area/f13/secret)
"dt" = (/turf/open/indestructible/ground/road{icon_state = "verticalleftborderright1"},/area/f13/wasteland)
"du" = (/obj/effect/decal/marking{tag = "icon-dottedverticalcorroded"; icon_state = "dottedverticalcorroded"},/turf/open/indestructible/ground/road,/area/f13/wasteland)
"dv" = (/turf/open/indestructible/ground/road{icon_state = "verticalinnermain2top"},/area/f13/wasteland)
"dw" = (/obj/structure/chair/comfy/black{dir = 4},/turf/open/floor/f13{icon_state = "floorrusty"},/area/f13/secret)
"dx" = (/obj/structure/table,/obj/item/weapon/reagent_containers/food/drinks/drinkingglass/shotglass,/turf/open/floor/f13{icon_state = "floordirty"},/area/f13/secret)
"dy" = (/obj/structure/table,/obj/item/weapon/reagent_containers/food/drinks/bottle/whiskey{pixel_x = -15; pixel_y = -10},/turf/open/floor/f13{icon_state = "floordirty"},/area/f13/secret)
"dz" = (/obj/structure/chair/comfy/black{dir = 8},/turf/open/floor/f13{icon_state = "floordirty"},/area/f13/secret)
"dA" = (/obj/structure/simple_door/brokenglass,/turf/open/floor/f13{icon_state = "floorrusty"},/area/f13/secret)
"dB" = (/obj/effect/decal/marking{tag = "icon-dottedverticalcorroded"; icon_state = "dottedverticalcorroded"},/turf/open/indestructible/ground/road{icon_state = "verticalinnermain1"},/area/f13/wasteland)
"dC" = (/turf/open/indestructible/ground/road{icon_state = "verticalinnermain3"},/area/f13/wasteland)
"dD" = (/turf/closed/wall/f13/supermart{desc = "Remove kebab."; icon_state = "storeprewindowvertical"; name = "kebab outpost wall"},/area/f13/secret)
"dE" = (/obj/structure/table,/obj/item/weapon/coin/silver,/turf/open/floor/f13{icon_state = "floorrusty"},/area/f13/secret)
"dF" = (/obj/structure/table,/obj/item/weapon/reagent_containers/food/drinks/drinkingglass/shotglass{pixel_y = 5},/turf/open/floor/f13{icon_state = "floorrusty"},/area/f13/secret)
"dG" = (/obj/structure/chair/comfy/black{dir = 8},/turf/open/floor/f13{icon_state = "floorrusty"},/area/f13/secret)
"dH" = (/obj/structure/chair/wood/modern{dir = 4},/turf/open/floor/f13{icon_state = "floordirty"},/area/f13/secret)
"dI" = (/obj/structure/table,/obj/item/clothing/under/f13/bodyguard,/obj/item/weapon/reagent_containers/food/snacks/f13/mre{pixel_y = 4},/turf/open/floor/f13{icon_state = "floordirty"},/area/f13/secret)
"dJ" = (/obj/item/weapon/gun/ballistic/revolver/magnum{level = 3; pixel_y = -5},/obj/structure/bed,/obj/item/weapon/bedsheet/patriot,/turf/open/floor/f13{icon_state = "floorrusty"},/area/f13/secret)
"dK" = (/obj/effect/decal/marking,/turf/open/indestructible/ground/road,/area/f13/wasteland)
"dL" = (/obj/structure/chair/comfy/black{dir = 1},/turf/open/floor/f13{icon_state = "floorrusty"},/area/f13/secret)
"dM" = (/obj/structure/table,/obj/structure/bedsheetbin,/turf/open/floor/f13{icon_state = "bluerustychess"},/area/f13/secret)
"dN" = (/obj/structure/mirror{pixel_y = 29},/obj/structure/sink{pixel_y = 20},/turf/open/floor/f13{icon_state = "bluedirtychess"},/area/f13/secret)
"dO" = (/obj/structure/table,/obj/item/weapon/lipstick,/turf/open/floor/f13{icon_state = "bluedirtychess"},/area/f13/secret)
"dP" = (/obj/structure/table,/obj/item/weapon/folder/yellow/secret,/turf/open/floor/f13{icon_state = "floorrusty"},/area/f13/secret)
"dQ" = (/obj/structure/table,/obj/item/weapon/paper{pixel_x = -4; pixel_y = -4},/obj/item/weapon/paper{pixel_y = 4},/obj/item/weapon/paper{pixel_x = 9},/obj/item/weapon/pen/blue,/turf/open/floor/f13{icon_state = "floorrusty"},/area/f13/secret)
"dR" = (/obj/structure/table,/obj/item/weapon/paper/nuke_instructions,/turf/open/floor/f13{icon_state = "floorrusty"},/area/f13/secret)
"dS" = (/obj/structure/simple_door/room,/turf/open/floor/f13{icon_state = "bluedirtychess"},/area/f13/secret)
"dT" = (/turf/open/floor/f13{icon_state = "bluedirtychess"},/area/f13/secret)
"dU" = (/obj/structure/chair/stool/blue,/turf/open/floor/f13{icon_state = "bluerustychess2"},/area/f13/secret)
"dV" = (/obj/structure/filingcabinet/filingcabinet,/turf/open/floor/f13{icon_state = "floordirty"},/area/f13/secret)
"dW" = (/obj/structure/chair/office/blue{dir = 1},/turf/open/floor/f13{icon_state = "floorrusty"},/area/f13/secret)
"dX" = (/obj/machinery/light,/turf/open/floor/f13{icon_state = "floorrusty"},/area/f13/secret)
"dY" = (/obj/machinery/light/small,/turf/open/floor/f13{icon_state = "bluerustychess"},/area/f13/secret)
"dZ" = (/obj/structure/toilet{dir = 8},/turf/open/floor/f13{icon_state = "bluedirtychess"},/area/f13/secret)
"ea" = (/turf/open/indestructible/ground/road{icon_state = "verticalleftborderright2"},/area/f13/wasteland)
"eb" = (/turf/open/indestructible/ground/sidewalk{dir = 4; icon_state = "outercornermisc"},/area/f13/wasteland)
"ec" = (/turf/open/indestructible/ground/sidewalk{icon_state = "verticalleftborderleftbottom"},/area/f13/wasteland)
"ed" = (/turf/open/indestructible/ground/road{icon_state = "verticalleftborderrightbottom"},/area/f13/wasteland)
"ee" = (/turf/open/indestructible/ground/road{icon_state = "verticalrightborderleftbottom"},/area/f13/wasteland)
"ef" = (/turf/open/indestructible/ground/sidewalk{icon_state = "verticalrightborderrightbottom"},/area/f13/wasteland)
"eg" = (/turf/open/indestructible/ground/sidewalk{dir = 1; icon_state = "outercornermisc"},/area/f13/wasteland)

(1,1,1) = {"
aaaaaaaaaaaaaaababaaacadaaaeafaaaaaaaaaaaaaaaaaaaaaaaaaaaaag
aaahaaaiacaaababajabacakaaalamaianananananananananananananad
aaaianaoapababababaqaparanadaaasatauavawawawaxayatatatatatak
aaasazazazazazaAazazazazazakaaasaBaCaDaDaDaDaDaEataFaGaHatak
aaasazaIaJaKaLaLaMaNaLaOazakaaasaPaDaDaQaDaRaQaQaSaTaTaUatak
aaasazaLaLaLaLaLaLaLaLaLazakaaasaVaDaWaXaYaZaDaQatbaaTbbatak
aaasazbcaLaLbdaLaLbebfbgazakaaasbhaDbibjbibiaDaDatatatatatak
aaasazaJbkaLaLaLaLbeblbgazakaaasbmbnaDaDaQaQaDboatbpbpbqatak
brasazaLaLbsaLaLaLbsaLaLazbtbubvatbwbxaDaDbyaQaDbzaQaDbAatak
aaasazazbBazazbCazazbDazazakaaasatbEbEaQbFaDaDaDataDbGbHatak
aabIbJbJbJbJbKbLbMbJbJbJbJbNaaasatbObPaQaQaDaDbQataDaQbRatak
aaaaaaaaaaaaasbLakaaaaaaaaaaaaasatbSbSaDaQaDaDbTatbUbVbWatak
aianananananaobLaranananadahaaasatatatatatbXatatatatatatatak
asbLbYbZcacbcccdcececfbLakaaaaasbLcgatchcicjcjckcjcjclatcmbN
ascncocpcqcqcpcrcscpctcuarananaobLbLatcjcjcjcjcvcwcjcjatcxaa
ascyczczczcAcAczczczczcBbLbLbLbLbLbLcCcjcjcjcjcDcEcjcjcCcxaa
ascycFcGcAcAcAcAcHcGcIcBbMbJbJbKbLbLatcjcjcjcjcvcvcjcJatcxaa
ascKcLcAcMcNcOcMcAcGcPcQakaaaaasbLcgatcRcjcjcjcScjcjcTatcUad
ascKcLcNcVcWcXcOcGcGcPcQcYaaaaasatatatatatbXatatatatatatatak
ascKcLcZdaaaaadbcGcGcPcBakaaaaasaBdcdddedfaQaQdgatdhdidjatak
ascycLcGcZdadkdlcAcGdmcBakaaaaasaPaDaDaQaDaQaDdnataDaDbRatak
asdodpcGcGcZdlcAcGcGdqdrakaaaaasaVaQaQdsdsaDaDaQataQaDaQatak
bIbKcKdtcGcGdudvcGcPcBbMbNaaaaasaVaQdwdxdydzaDaDdAaDaDbAatak
aaascKdtcAcGdBdCcMdmcQakaaaaaaasdDaQdwdEdFdGaDaQatdHdIdJatak
aaascKdtcGcGdKcMcAcPcQakaaaaaaasaVaQaDdLdLaDaQboatatatatatak
aaascycLcHcGducGcGcPcBakaaaaaaasaVaQaQaDaQaDaDaDatdMdNdOatak
aaascycLcGcGducAcGcPcBcYaaaaaaasbhdPdQdRaDaQaDaQdSdTdTdUatak
aaascKcLcGcAcAcAcAcPcBakaaaaaaasbmdVdWdXaDdXaQaDatdTdYdZatak
aaascyeacMcNcVcOcMdmcQakaaaaahasatatatatatatatatatatatatatak
aaebecedcVcWaacXcVeeefegaaaaaabIbJbJbJbJbJbJbJbJbJbJbJbJbJbN
"}
