"aa" = (/turf/closed/mineral,/area/f13/wasteland)
"ab" = (/turf/open/indestructible/ground/desert,/area/f13/wasteland)
"ac" = (/obj/effect/decal/goo,/turf/open/indestructible/ground/mountain,/area/f13/wasteland)
"ad" = (/obj/structure/statue/uranium/nuke,/turf/open/indestructible/ground/mountain,/area/f13/wasteland)
"ae" = (/obj/structure/barrel/dangerous,/turf/open/indestructible/ground/mountain,/area/f13/wasteland)
"af" = (/turf/open/indestructible/ground/mountain,/area/f13/wasteland)
"ag" = (/obj/structure/bed/mattress/holey,/turf/open/indestructible/ground/mountain,/area/f13/wasteland)
"ah" = (/turf/closed/wall/f13/wood/house,/area/f13/wasteland)
"ai" = (/obj/structure/window/fulltile/ruins/broken,/turf/open/floor/f13/wood,/area/f13/wasteland)
"aj" = (/obj/structure/closet,/obj/item/weapon/spear,/obj/item/weapon/spear,/obj/item/weapon/spear,/obj/item/weapon/gun/ballistic/automatic/pistol/n99,/turf/open/floor/f13/wood,/area/f13/wasteland)
"ak" = (/turf/open/floor/f13/wood,/area/f13/wasteland)
"al" = (/obj/structure/table/wood/settler,/obj/item/device/flashlight/lantern,/obj/item/weapon/restraints/legcuffs/bola/tribal,/turf/open/floor/f13/wood,/area/f13/wasteland)
"am" = (/obj/structure/chair/wood{dir = 8},/obj/structure/decoration/clock/old/active{pixel_y = 32},/turf/open/floor/f13/wood,/area/f13/wasteland)
"an" = (/mob/living/simple_animal/hostile/ghoul,/turf/open/indestructible/ground/desert,/area/f13/wasteland)
"ao" = (/obj/item/stack/sheet/mineral/wood,/turf/open/floor/f13/wood,/area/f13/wasteland)
"ap" = (/obj/machinery/light/small,/turf/open/floor/f13/wood,/area/f13/wasteland)
"aq" = (/obj/structure/table/wood/settler,/obj/item/device/flashlight/lantern,/turf/open/indestructible/ground/mountain,/area/f13/wasteland)
"ar" = (/turf/closed/wall/f13/wood/interior,/area/f13/wasteland)
"as" = (/obj/structure/simple_door/room,/obj/structure/decoration/rag,/turf/open/floor/f13/wood,/area/f13/wasteland)
"at" = (/obj/structure/table/wood/settler,/obj/item/seeds/shroom,/obj/item/seeds/shroom,/turf/open/indestructible/ground/mountain,/area/f13/wasteland)
"au" = (/mob/living/simple_animal/hostile/ghoul/glowing,/turf/open/indestructible/ground/mountain,/area/f13/wasteland)
"av" = (/obj/structure/table/wood/settler,/obj/item/weapon/twohanded/tribal_spear,/turf/open/indestructible/ground/mountain,/area/f13/wasteland)
"aw" = (/obj/machinery/light/small{dir = 8},/turf/open/floor/f13/wood,/area/f13/wasteland)
"ax" = (/obj/structure/flora/tree/wasteland,/turf/open/indestructible/ground/desert,/area/f13/wasteland)
"ay" = (/obj/structure/fence,/turf/open/indestructible/ground/desert,/area/f13/wasteland)
"az" = (/turf/closed/wall/f13/ruins,/area/f13/wasteland)
"aA" = (/obj/effect/decal/goo,/turf/open/indestructible/ground/desert,/area/f13/wasteland)
"aB" = (/obj/structure/simple_door/metal/barred,/obj/structure/decoration/rag,/turf/open/indestructible/ground/mountain,/area/f13/wasteland)
"aC" = (/turf/open/ruins,/area/f13/wasteland)
"aD" = (/obj/structure/bed/mattress/holey,/turf/open/ruins,/area/f13/wasteland)
"aE" = (/obj/structure/bed/mattress/holey,/turf/open/ruins{tag = "icon-rubble (NORTHWEST)"; icon_state = "rubble"; dir = 9},/area/f13/wasteland)
"aF" = (/obj/structure/sink/puddle,/turf/open/indestructible/ground/desert,/area/f13/wasteland)
"aG" = (/obj/item/stack/sheet/mineral/wood,/turf/open/indestructible/ground/desert,/area/f13/wasteland)
"aH" = (/obj/item/stack/sheet/animalhide/human,/turf/open/ruins,/area/f13/wasteland)
"aI" = (/turf/open/ruins{tag = "icon-rubble (NORTH)"; icon_state = "rubble"; dir = 1},/area/f13/wasteland)
"aJ" = (/turf/open/ruins{tag = "icon-rubblecorner (NORTH)"; icon_state = "rubblecorner"; dir = 1},/area/f13/wasteland)
"aK" = (/mob/living/simple_animal/hostile/ghoul/glowing,/turf/open/indestructible/ground/desert,/area/f13/wasteland)
"aL" = (/obj/structure/fence,/turf/open/ruins{tag = "icon-rubblecorner (EAST)"; icon_state = "rubblecorner"; dir = 4},/area/f13/wasteland)
"aM" = (/turf/open/ruins{dir = 1; icon_state = "rubblecorner"; tag = "icon-rubblecorner (WEST)"},/area/f13/wasteland)
"aN" = (/obj/item/stack/sheet/animalhide/human,/turf/open/indestructible/ground/desert,/area/f13/wasteland)
"aO" = (/obj/item/trash/can,/turf/open/indestructible/ground/desert,/area/f13/wasteland)
"aP" = (/obj/item/weapon/shovel,/turf/open/indestructible/ground/desert,/area/f13/wasteland)
"aQ" = (/obj/structure/window/fulltile/ruins/broken,/turf/open/indestructible/ground/desert,/area/f13/wasteland)
"aR" = (/obj/structure/fence/door,/turf/open/indestructible/ground/desert,/area/f13/wasteland)
"aS" = (/obj/machinery/hydroponics/soil,/turf/open/indestructible/ground/desert,/area/f13/wasteland)
"aT" = (/turf/closed/wall/f13/wood/house/broken,/area/f13/wasteland)
"aU" = (/obj/structure/flora/cactus,/turf/open/indestructible/ground/desert,/area/f13/wasteland)
"aV" = (/obj/structure/table/wood/settler,/obj/item/weapon/reagent_containers/pill/patch/healpowder,/obj/item/weapon/reagent_containers/pill/patch/healpowder,/obj/item/weapon/reagent_containers/pill/patch/healpowder,/turf/open/floor/f13/wood,/area/f13/wasteland)
"aW" = (/obj/structure/bed/mattress/holey,/turf/open/floor/f13/wood,/area/f13/wasteland)
"aX" = (/turf/open/floor/f13/wood{tag = "icon-housebase3-broken"; icon_state = "housebase3-broken"},/area/f13/wasteland)
"aY" = (/obj/structure/table/wood/settler,/obj/item/seeds/broc,/obj/item/seeds/broc,/obj/item/seeds/broc,/obj/item/seeds/xander,/obj/item/seeds/xander,/obj/item/seeds/xander,/turf/open/floor/f13/wood,/area/f13/wasteland)
"aZ" = (/turf/open/floor/f13/wood{tag = "icon-housebase"; icon_state = "housebase"},/area/f13/wasteland)
"ba" = (/obj/structure/simple_door/room,/obj/structure/decoration/rag,/turf/open/indestructible/ground/desert,/area/f13/wasteland)
"bb" = (/obj/item/stack/sheet/animalhide/molerat,/obj/item/stack/sheet/animalhide/molerat,/turf/open/floor/f13/wood,/area/f13/wasteland)
"bc" = (/obj/structure/flora/tree/tall,/turf/open/indestructible/ground/desert,/area/f13/wasteland)
"bd" = (/obj/item/trash/candle,/turf/open/indestructible/ground/desert,/area/f13/wasteland)
"be" = (/obj/structure/closet,/obj/item/weapon/twohanded/tribal_spear,/turf/open/floor/f13/wood,/area/f13/wasteland)
"bf" = (/obj/structure/chair/wood,/turf/open/floor/f13/wood,/area/f13/wasteland)
"bg" = (/obj/item/chair/stool,/turf/open/floor/f13/wood,/area/f13/wasteland)
"bh" = (/obj/structure/chair/wood{dir = 4},/turf/open/floor/f13/wood,/area/f13/wasteland)
"bi" = (/obj/structure/table/wood/settler,/turf/open/floor/f13/wood,/area/f13/wasteland)
"bj" = (/obj/structure/barrel/dangerous,/turf/open/indestructible/ground/desert,/area/f13/wasteland)
"bk" = (/obj/structure/closet,/obj/item/weapon/restraints/legcuffs/bola/tribal,/obj/item/weapon/restraints/legcuffs/bola/tribal,/turf/open/floor/f13/wood,/area/f13/wasteland)
"bl" = (/obj/structure/simple_door/brokenglass,/turf/open/indestructible/ground/desert,/area/f13/wasteland)
"bm" = (/obj/structure/simple_door/dirtyglass,/obj/structure/decoration/rag,/turf/open/indestructible/ground/desert,/area/f13/wasteland)
"bn" = (/obj/item/weapon/twohanded/tribal_spear,/turf/open/floor/f13/wood,/area/f13/wasteland)
"bo" = (/obj/item/weapon/restraints/legcuffs/bola/tribal,/turf/open/floor/f13/wood,/area/f13/wasteland)
"bp" = (/obj/structure/tires,/turf/open/indestructible/ground/desert,/area/f13/wasteland)
"bq" = (/obj/structure/tires/five,/turf/open/indestructible/ground/desert,/area/f13/wasteland)
"br" = (/obj/structure/barrel/old,/turf/open/indestructible/ground/desert,/area/f13/wasteland)
"bs" = (/obj/structure/barrel/three,/turf/open/indestructible/ground/desert,/area/f13/wasteland)
"bt" = (/obj/structure/barrel/two,/turf/open/indestructible/ground/desert,/area/f13/wasteland)
"bu" = (/obj/structure/barrel/four,/turf/open/indestructible/ground/desert,/area/f13/wasteland)
"bv" = (/obj/structure/tires/two,/turf/open/indestructible/ground/desert,/area/f13/wasteland)
"bw" = (/obj/structure/tires/half,/turf/open/indestructible/ground/desert,/area/f13/wasteland)

(1,1,1) = {"
aaaaaaaaaaaaaaaaaaaaaaaaaaaaaaaaaaaaaaaaaaaaaaaaaaaaaaaaaaaaaaaaaaaaaaaaaaaaaaaaaaaaaaaaaaaaaaaaaaaa
aaaaaaaaaaaaaaaaaaaaabaaaaaaaaaaaaaaaaaaaaaaaaaaaaaaaaaaaaaaaaaaacacadaeaaaaaaaaaaaaaaaaaaaaaaaaaaaa
aaaaaaaaaaaaababababababaaaaaaaaaaaaaaaaaaaaaaaaaaaaaaaaaaaaaaaaafafagacaaaaaaaaaaaaaaaaaaaaaaaaaaaa
aaaaaaaaabababababababababaaaaaaaaaaaaaaaaaaaaaaaaaaaaaaaaaaaaacafafafaeacaaaaaaaaaaaaaaaaaaaaaaaaaa
aaaaaaabababahahaiahahahabaaaaaaaaaaaaaaaaaaaaaaaaaaaaaaaaaaaaaeacafafacacaaaaaaaaaaaaaaaaaaaaaaaaaa
aaaaababababahajakalamahababaaaaaaaaaaaaaaaaaaaaaaaaaaaaaaaaaaaaaaafafaaaaaaaaaaaaaaaaaaaaaaaaaaaaaa
aaaaababanabahakakaoapahabababaaaaaaaaaaaaaaaaaaaaaaaaaaaaaaaqafafafafafafafafaqaaaaaaaaaaaaaaaaaaaa
aaabababababaharasararahababababaaabaaaaaaaaaaaaaaaaaaaaaaaaatafafafafafafauafavaaaaaaaaaaaaaaaaaaaa
aaaaababababahawakakakahabababababababaaaaaaaaaaaaababaaaaaaaaafafafafafacafaaaaaaaaaaaaaaaaaaaaaaaa
aaaaababababahakakakakaiababaxabababababababaaaaaaababayaaaaaaaaafafafafafafaaaaaaaaaaaaaaaaaaaaaaaa
aaaaaaabababahahababahahabababababababababababababababayabaaaaaaaaaaafaaaaaaaaaaaaaaaaaaaaaaaaaaaaaa
aaaaaaabababababababahabababababazazazazazazabababababayabababaAabaaaBaaaaaaaaaaaaaaaaaaaaaaaaaaaaaa
aaaaaaaaababanabababababababababazaCaDaCaEazabababababayababaFababababababaaaaaaaaaaaaaaaaaaaaabaaaa
aaaaaaaaabaAababaGabababababababazaHaEaIaJazabababababayabaKabababababababababaaaaaaababaaaaabababab
aaaaaaaaababababababababababababaLaIaMabaNayabababababayababaOabaAababababaAabababayabababababababab
aaaaaaaaaaabababababababababababayabayayayazabababababayababaPababababababababababayabababababababab
aaaaaaaaaaabababahaQahahababababayaRayababababababababayabaSababababahaTaTaTahahabayabababababababab
aaaaaaaaabababahahakakahababababababababababababaUanabayabaSababababahakakakaVahabayabababababababab
aaaaaaaaabababahakaWaXabababanababababababababababababayabaSabababababakabakaYaTabayabababababababab
aaaaaaaaaaababahaZakakabababababababaGabababaGababababayabaSababababaTakaGakakaTabayabababababababab
aaaaaaaaaaaaabahahahahahababababababababababababaAababayabaSababababbaakakakakahabayabababababababab
aaaaaaaaaaababababababababababababababababababababababayabaSababababaTakakabbbahabayabababababababab
aaaaaaaaaaababababahahahahaiahahababaGababababababababayabaSababababaTaTahahahahabayabababababababab
aaaaaaaaabababababahakakakaoakahabbcababababababababababababababbdaAabababababababayabababababababab
aaaaaaaaababababahahakbeaZaZakahabababababababababababababababababababababababababayabababababababab
aaaaaaaaaaabababahakakakakakakahahahababababababababababababayayayayayayayayayayayayabababababababab
aaaaaaaaabababahahakakakbfbgakakakahabababababababababababababababababababababababababababababababab
aaaaaaababababaiakbhbibibibibiaXakbaabababababababababababababababababababababababababbjabababababab
aaaaaaababababaiakbhbibibibibiakakababababababababababababababababababababababababababababababababab
aaaaaaababababahahakakakakakaZaZakahabababababaAabababababaAababababababaxababababababababababababab
aaaaaaaaababababahakaZakakakakahahahabababababababababababababababababababababababababababababababab
aaaaaaaaababababahahakakakakbkahabababababababahblararahahababababababababababababababababababababab
aaaaaaaaaaababababahakakakakakahabababababararahaGakakakbmabababababababababababababbjababababababab
aaaaaaaaabababababahahahahaiahahababababababblabakakakakahababababababababababababababababababababab
aaaaaaaaaaabababababababababababababababababarahahakaWbnahababababababababababababababababababababab
aaaaaaaaaaababababababababababababababaAababababahboakakahababababababababababababababababababababab
aaaaaaaaababababababababababbpabababababababababahaTaTaTahababababababababbjabababababababababababab
aaaaaaaaababababababanabbqabbrababababababababababababababababababababababababababababababababababab
aaaaaaaaaaababababababbsbtbuabbvabababababababababababababababababababababababababababababababababab
aaaaaaaaabababababababbvbubsbpbrabababababababababababababababababababababababababababababababababab
aaaaaaaaabababababababbpababbwababbqabababababababababababababababababababababababababababababababab
aaaaaaaaaaababababababababbrabababababababababababababababababababababababababababababababababababab
aaaaaaaaaaaaabababababababababababababababababababababababababababbjabababababababababababababababab
aaaaaaaaaaaaaaababababababababababababababababababababababbjabababababababababababababababababababab
aaaaaaaaaaaaabababbjababababababababbjababababababababababababababababababababababababababababababab
aaaaaaaaaaabababababababababababababababababababbjababababababababababababababababababababababababab
aaaaaaaaaaabababababababababbjababababababababababababababababababababababababababababababababababab
aaaaaaaaabababababababababababababababababababababababababababababababababababababababababababababab
aaaaaaaaabababababababababababababababababababababababababababababababababababababababababababababab
aaaaaaaaabababababababababababababababababababababababababababababababababababababababababababababab
"}
