"a" = (/turf/closed/wall/shuttle/survival/pod,/area/f13/secret)
"b" = (/obj/structure/sign/mining/survival{tag = "icon-survival (NORTH)"; icon_state = "survival"; dir = 1},/turf/closed/wall/shuttle/survival/pod,/area/f13/secret)
"c" = (/obj/structure/fans,/turf/open/floor/f13{icon_state = "darksolid"},/area/f13/secret)
"d" = (/obj/machinery/smartfridge/survival_pod,/turf/open/floor/f13{icon_state = "darksolid"},/area/f13/secret)
"e" = (/obj/item/device/gps/computer,/turf/open/floor/f13{icon_state = "darksolid"},/area/f13/secret)
"f" = (/obj/structure/sign/mining/survival{dir = 8},/turf/closed/wall/shuttle/survival/pod,/area/f13/secret)
"g" = (/obj/machinery/sleeper/survival_pod,/turf/open/floor/f13{icon_state = "darksolid"},/area/f13/secret)
"h" = (/turf/open/floor/f13{icon_state = "darksolid"},/area/f13/secret)
"i" = (/obj/structure/bed/pod,/obj/item/weapon/bedsheet/black,/turf/open/floor/f13{icon_state = "darksolid"},/area/f13/secret)
"j" = (/obj/structure/sign/mining/survival{tag = "icon-survival (EAST)"; icon_state = "survival"; dir = 4},/turf/closed/wall/shuttle/survival/pod,/area/f13/secret)
"k" = (/obj/structure/table/survival_pod,/obj/item/device/flashlight/torch/flare/blue,/obj/item/device/flashlight/torch/flare/blue,/turf/open/floor/f13{icon_state = "darksolid"},/area/f13/secret)
"l" = (/obj/structure/tubes,/obj/structure/chair/comfy/black{dir = 8},/turf/open/floor/f13{icon_state = "darksolid"},/area/f13/secret)
"m" = (/obj/structure/sign/mining/survival,/turf/closed/wall/shuttle/survival/pod,/area/f13/secret)
"n" = (/obj/structure/fans/tiny,/obj/machinery/door/airlock/survival_pod,/turf/open/floor/f13{icon_state = "darkdir"},/area/f13/secret)
"o" = (/obj/structure/sign/mining,/turf/closed/wall/shuttle/survival/pod,/area/f13/secret)

(1,1,1) = {"
aabaa
acdea
fghij
akhla
amnoa
"}
