//MAP CONVERTED BY dmm2tgm.py THIS HEADER COMMENT PREVENTS RECONVERSION, DO NOT REMOVE
"a" = (
/turf/open/indestructible/ground/outside/dirt/dark,
/area/f13/wasteland)
"b" = (
/obj/item/candle/tribal_torch,
/turf/open/indestructible/ground/outside/dirt/dark,
/area/survivalpod)
"c" = (
/obj/structure/campfire,
/turf/open/indestructible/ground/outside/dirt/dark,
/area/survivalpod)
"f" = (
/turf/closed/wall/f13/tentwall,
/area/survivalpod)
"h" = (
/obj/structure/closet/crate/wicker,
/turf/open/indestructible/ground/outside/dirt,
/area/survivalpod)
"i" = (
/obj/structure/bed,
/obj/item/bedsheet/brown,
/turf/open/floor/f13/wood,
/area/survivalpod)
"o" = (
/obj/structure/chair/f13foldupchair,
/turf/open/indestructible/ground/outside/dirt/dark,
/area/survivalpod)
"u" = (
/obj/machinery/workbench,
/turf/open/indestructible/ground/outside/dirt,
/area/survivalpod)
"w" = (
/obj/machinery/workbench/forge,
/turf/open/indestructible/ground/outside/dirt,
/area/survivalpod)
"x" = (
/obj/structure/table/wood/settler,
/turf/open/indestructible/ground/outside/dirt,
/area/survivalpod)
"F" = (
/obj/structure/chair/f13foldupchair{
	dir = 8
	},
/turf/open/indestructible/ground/outside/dirt/dark,
/area/survivalpod)
"G" = (
/turf/open/indestructible/ground/outside/dirt/dark,
/area/survivalpod)
"H" = (
/obj/structure/simple_door/tent,
/turf/open/floor/f13/wood,
/area/survivalpod)
"K" = (
/obj/structure/table/wood/settler,
/obj/effect/spawner/lootdrop/f13/alcoholspawner,
/obj/effect/spawner/lootdrop/f13/alcoholspawner,
/obj/effect/spawner/lootdrop/f13/alcoholspawner,
/turf/open/indestructible/ground/outside/dirt,
/area/survivalpod)
"M" = (
/obj/structure/table/wood/settler,
/obj/effect/spawner/lootdrop/f13/foodspawner,
/obj/effect/spawner/lootdrop/f13/foodspawner,
/obj/effect/spawner/lootdrop/f13/foodspawner,
/turf/open/floor/f13/wood,
/area/survivalpod)
"N" = (
/turf/open/indestructible/ground/outside/dirt,
/area/survivalpod)
"O" = (
/obj/structure/rack,
/obj/item/storage/toolbox/mechanical/old,
/obj/item/stack/crafting/goodparts/five,
/obj/item/stack/crafting/metalparts/three,
/obj/item/stack/sheet/metal/twenty,
/obj/item/stack/crafting/electronicparts/three,
/turf/open/indestructible/ground/outside/dirt,
/area/survivalpod)
"R" = (
/obj/structure/chair/f13foldupchair{
	dir = 4;
	icon_state = "f13foldupchair"
	},
/turf/open/indestructible/ground/outside/dirt/dark,
/area/survivalpod)
"W" = (
/turf/open/floor/f13/wood,
/area/survivalpod)
"Y" = (
/obj/structure/rack,
/obj/machinery/autolathe/constructionlathe,
/turf/open/indestructible/ground/outside/dirt,
/area/survivalpod)

(1,1,1) = {"
f
f
f
f
f
a
a
"}
(2,1,1) = {"
f
w
N
N
b
G
R
"}
(3,1,1) = {"
f
N
N
N
G
o
c
"}
(4,1,1) = {"
f
Y
N
N
K
G
F
"}
(5,1,1) = {"
f
h
N
N
x
G
a
"}
(6,1,1) = {"
f
u
N
N
G
G
a
"}
(7,1,1) = {"
f
O
N
N
b
a
a
"}
(8,1,1) = {"
f
f
H
f
f
a
a
"}
(9,1,1) = {"
f
M
W
f
a
a
a
"}
(10,1,1) = {"
f
i
W
f
a
a
a
"}
(11,1,1) = {"
f
f
f
f
a
a
a
"}
