//MAP CONVERTED BY dmm2tgm.py THIS HEADER COMMENT PREVENTS RECONVERSION, DO NOT REMOVE
"e" = (
/obj/structure/sink{
	dir = 8;
	pixel_x = -12
	},
/obj/structure/mirror{
	pixel_x = -32
	},
/turf/open/indestructible/ground/outside/civ/thatch1,
/area/survivalpod)
"f" = (
/obj/structure/toilet{
	dir = 8
	},
/obj/machinery/light/small{
	dir = 4
	},
/turf/open/indestructible/ground/outside/civ/thatch1,
/area/survivalpod)
"i" = (
/obj/structure/bed/double,
/obj/item/bedsheet/doublesheetred{
	color = "#FF9999"
	},
/turf/open/indestructible/ground/outside/civ/thatch1,
/area/survivalpod)
"k" = (
/obj/structure/table/wood/settler,
/obj/item/reagent_containers/food/snacks/loadedbakedpotato,
/obj/item/storage/fancy/candle_box,
/obj/item/lighter/greyscale,
/obj/structure/chair/stool,
/turf/open/indestructible/ground/outside/civ/thatch1,
/area/survivalpod)
"o" = (
/obj/structure/window/fulltile/civ/oriental_windownew,
/obj/structure/curtain/directional/east{
	color = "#FF4444"
	},
/turf/open/indestructible/ground/outside/civ/thatch1,
/area/survivalpod)
"p" = (
/obj/structure/ladder/unbreakable/door_teleport,
/turf/open/indestructible/ground/outside/civ/thatch1,
/area/survivalpod)
"q" = (
/obj/structure/window/fulltile/civ/oriental_windownew,
/obj/structure/curtain/directional/south{
	color = "#FF4444"
	},
/turf/open/indestructible/ground/outside/civ/thatch1,
/area/survivalpod)
"r" = (
/obj/structure/window/fulltile/civ/oriental_windownew,
/obj/structure/curtain/directional/west{
	color = "#FF4444"
	},
/turf/open/indestructible/ground/outside/civ/thatch1,
/area/survivalpod)
"s" = (
/obj/item/flashlight/oldlamp,
/turf/open/indestructible/ground/outside/civ/thatch1,
/area/survivalpod)
"t" = (
/obj/structure/table/wood/settler,
/turf/open/indestructible/ground/outside/civ/thatch1,
/area/survivalpod)
"w" = (
/turf/open/indestructible/ground/outside/civ/thatch1,
/area/survivalpod)
"x" = (
/obj/machinery/light/small{
	dir = 4
	},
/turf/open/indestructible/ground/outside/civ/thatch1,
/area/survivalpod)
"A" = (
/obj/structure/table/wood/settler,
/obj/item/reagent_containers/food/snacks/grown/buffalogourd,
/turf/open/indestructible/ground/outside/civ/thatch1,
/area/survivalpod)
"B" = (
/obj/structure/closet/crate/wicker,
/obj/item/reagent_containers/food/snacks/grown/xander,
/obj/item/reagent_containers/food/snacks/grown/xander,
/obj/item/reagent_containers/food/snacks/grown/tato,
/obj/item/reagent_containers/food/snacks/grown/tato,
/obj/item/reagent_containers/food/snacks/grown/mutfruit,
/obj/item/reagent_containers/food/snacks/grown/mutfruit,
/turf/open/indestructible/ground/outside/civ/thatch1,
/area/survivalpod)
"C" = (
/obj/structure/simple_door/tent,
/obj/item/lock_bolt{
	dir = 1
	},
/turf/open/indestructible/ground/outside/civ/thatch1,
/area/survivalpod)
"D" = (
/obj/structure/chair/stool,
/turf/open/indestructible/ground/outside/civ/thatch1,
/area/survivalpod)
"E" = (
/turf/closed/wall/f13/tentwall,
/area/survivalpod)
"F" = (
/obj/structure/dresser,
/turf/open/indestructible/ground/outside/civ/thatch1,
/area/survivalpod)
"T" = (
/obj/machinery/shower{
	dir = 8
	},
/obj/structure/decoration/vent,
/obj/structure/curtain/directional/west,
/turf/open/indestructible/ground/outside/civ/thatch1,
/area/survivalpod)
"W" = (
/obj/structure/table/wood/settler,
/obj/item/reagent_containers/food/snacks/meat/steak/aethergiest{
	desc = "A canned slab of aethergiest steak, pre-cooked and lasts forever!";
	icon_state = "porknbeans";
	name = "aethergiest dinner"
	},
/turf/open/indestructible/ground/outside/civ/thatch1,
/area/survivalpod)

(1,1,1) = {"
E
E
E
E
o
E
E
"}
(2,1,1) = {"
E
e
T
E
t
A
E
"}
(3,1,1) = {"
E
f
w
E
k
D
E
"}
(4,1,1) = {"
E
E
p
E
W
D
E
"}
(5,1,1) = {"
q
F
w
w
w
w
C
"}
(6,1,1) = {"
E
i
w
s
x
B
E
"}
(7,1,1) = {"
E
E
E
r
E
E
E
"}
