//MAP CONVERTED BY dmm2tgm.py THIS HEADER COMMENT PREVENTS RECONVERSION, DO NOT REMOVE
"a" = (
/turf/open/indestructible/ground/outside/dirt,
/area/survivalpod)
"g" = (
/obj/structure/fence/wooden,
/turf/open/indestructible/ground/outside/dirt,
/area/survivalpod)
"j" = (
/obj/machinery/smartfridge/bottlerack/seedbin,
/turf/open/indestructible/ground/outside/dirt,
/area/survivalpod)
"l" = (
/obj/structure/legion_extractor,
/turf/open/indestructible/ground/outside/dirt,
/area/survivalpod)
"m" = (
/obj/machinery/hydroponics/soil,
/obj/item/seeds/poppy/broc,
/turf/open/indestructible/ground/outside/dirt,
/area/survivalpod)
"p" = (
/obj/machinery/hydroponics/soil,
/obj/item/seeds/datura,
/turf/open/indestructible/ground/outside/dirt,
/area/survivalpod)
"r" = (
/obj/item/reagent_containers/glass/bucket/wood,
/obj/item/cultivator,
/obj/item/shovel/spade,
/turf/open/indestructible/ground/outside/dirt,
/area/survivalpod)
"s" = (
/obj/structure/reagent_dispensers/compostbin,
/turf/open/indestructible/ground/outside/dirt,
/area/survivalpod)
"v" = (
/obj/machinery/hydroponics/soil,
/turf/open/indestructible/ground/outside/dirt,
/area/survivalpod)
"y" = (
/obj/structure/simple_door/metal/fence/wooden{
	dir = 1
	},
/turf/open/indestructible/ground/outside/dirt,
/area/survivalpod)
"A" = (
/obj/machinery/hydroponics/soil,
/obj/item/seeds/yucca,
/turf/open/indestructible/ground/outside/dirt,
/area/survivalpod)
"C" = (
/obj/machinery/hydroponics/soil,
/obj/item/seeds/xander,
/turf/open/indestructible/ground/outside/dirt,
/area/survivalpod)
"E" = (
/obj/machinery/hydroponics/soil,
/obj/item/seeds/punga,
/turf/open/indestructible/ground/outside/dirt,
/area/survivalpod)
"F" = (
/obj/machinery/hydroponics/soil,
/obj/item/seeds/coyotetobacco,
/turf/open/indestructible/ground/outside/dirt,
/area/survivalpod)
"G" = (
/obj/machinery/hydroponics/soil,
/obj/item/seeds/mutfruit,
/turf/open/indestructible/ground/outside/dirt,
/area/survivalpod)
"K" = (
/obj/structure/fence/corner/wooden,
/turf/open/indestructible/ground/outside/dirt,
/area/survivalpod)
"O" = (
/obj/structure/sink/puddle,
/turf/open/indestructible/ground/outside/dirt,
/area/survivalpod)
"T" = (
/obj/machinery/smartfridge/bottlerack/grownbin,
/turf/open/indestructible/ground/outside/dirt,
/area/survivalpod)
"W" = (
/obj/machinery/hydroponics/soil,
/obj/item/seeds/fungus,
/turf/open/indestructible/ground/outside/dirt,
/area/survivalpod)
"X" = (
/obj/machinery/hydroponics/soil,
/obj/item/seeds/feracactus,
/turf/open/indestructible/ground/outside/dirt,
/area/survivalpod)
"Y" = (
/obj/machinery/hydroponics/soil,
/obj/item/seeds/agave,
/turf/open/indestructible/ground/outside/dirt,
/area/survivalpod)

(1,1,1) = {"
T
K
g
g
g
g
g
K
"}
(2,1,1) = {"
s
g
m
X
A
Y
E
g
"}
(3,1,1) = {"
j
g
C
p
F
W
G
g
"}
(4,1,1) = {"
a
y
v
v
v
v
v
g
"}
(5,1,1) = {"
l
g
v
v
v
v
v
g
"}
(6,1,1) = {"
O
g
v
v
v
v
v
g
"}
(7,1,1) = {"
r
K
g
g
g
g
g
K
"}
