//MAP CONVERTED BY dmm2tgm.py THIS HEADER COMMENT PREVENTS RECONVERSION, DO NOT REMOVE
"e" = (
/obj/structure/campfire/stove,
/turf/open/floor/carpet,
/area/survivalpod)
"f" = (
/obj/structure/table/wood/settler,
/obj/item/kitchen/knife/butcher/tribal,
/obj/item/melee/onehanded/knife/bone,
/obj/structure/destructible/tribal_torch/wall/lit{
	dir = 1
	},
/turf/open/floor/carpet,
/area/survivalpod)
"i" = (
/obj/structure/sink/puddle,
/turf/open/indestructible/ground/outside/dirt,
/area/survivalpod)
"k" = (
/obj/structure/destructible/tribal_torch/wall/lit{
	dir = 1
	},
/turf/open/floor/carpet,
/area/survivalpod)
"p" = (
/turf/open/floor/carpet,
/area/survivalpod)
"q" = (
/obj/item/flashlight/lantern,
/turf/open/floor/carpet,
/area/survivalpod)
"r" = (
/obj/structure/chair/bench,
/turf/open/floor/carpet,
/area/survivalpod)
"s" = (
/obj/structure/table/wood/settler,
/obj/machinery/processor/chopping_block,
/turf/open/floor/carpet,
/area/survivalpod)
"t" = (
/obj/structure/destructible/tribal_torch/wall/lit,
/turf/open/floor/carpet,
/area/survivalpod)
"w" = (
/obj/structure/table/wood/settler,
/obj/item/reagent_containers/food/snacks/meat/steak/deathclaw{
	desc = "A canned slab of deathclaw steak, pre-cooked and lasts forever!";
	icon_state = "porknbeans";
	name = "deathclaw dinner"
	},
/turf/open/floor/carpet,
/area/survivalpod)
"x" = (
/obj/structure/table/wood/settler,
/obj/item/reagent_containers/food/snacks/loadedbakedpotato,
/obj/item/storage/fancy/candle_box,
/obj/item/lighter/greyscale,
/turf/open/floor/carpet,
/area/survivalpod)
"A" = (
/obj/structure/rack/shelf_metal,
/turf/open/floor/carpet,
/area/survivalpod)
"B" = (
/obj/structure/chair/bench,
/obj/structure/destructible/tribal_torch/wall/lit,
/turf/open/floor/carpet,
/area/survivalpod)
"D" = (
/obj/structure/simple_door/tent,
/turf/open/floor/carpet,
/area/survivalpod)
"E" = (
/turf/closed/wall/f13/tentwall,
/area/survivalpod)

(1,1,1) = {"
E
E
E
E
E
E
E
"}
(2,1,1) = {"
E
e
p
p
A
A
E
"}
(3,1,1) = {"
E
f
p
p
p
t
E
"}
(4,1,1) = {"
E
s
p
q
p
p
D
"}
(5,1,1) = {"
E
k
p
r
w
B
E
"}
(6,1,1) = {"
E
i
p
r
x
r
E
"}
(7,1,1) = {"
E
E
E
E
E
E
E
"}
