//MAP CONVERTED BY dmm2tgm.py THIS HEADER COMMENT PREVENTS RECONVERSION, DO NOT REMOVE
"j" = (
/turf/open/indestructible/ground/outside/dirt,
/area/survivalpod)
"u" = (
/turf/closed/wall/f13/tentwall,
/area/survivalpod)
"v" = (
/obj/structure/rack/shelf_metal,
/turf/open/indestructible/ground/outside/dirt,
/area/survivalpod)
"x" = (
/obj/structure/bed/wooden,
/turf/open/indestructible/ground/outside/dirt,
/area/survivalpod)
"y" = (
/obj/structure/destructible/tribal_torch/wall/lit,
/turf/open/indestructible/ground/outside/dirt,
/area/survivalpod)
"D" = (
/obj/structure/table/wood,
/obj/item/flashlight/lantern,
/turf/open/indestructible/ground/outside/dirt,
/area/survivalpod)
"G" = (
/obj/structure/simple_door/tent,
/turf/open/indestructible/ground/outside/dirt,
/area/survivalpod)
"K" = (
/obj/structure/chair/wood,
/turf/open/indestructible/ground/outside/dirt,
/area/survivalpod)

(1,1,1) = {"
u
u
u
u
u
u
u
u
"}
(2,1,1) = {"
u
D
K
j
u
j
D
u
"}
(3,1,1) = {"
u
K
j
j
G
j
x
u
"}
(4,1,1) = {"
G
j
j
y
u
u
u
u
"}
(5,1,1) = {"
u
v
j
j
G
j
x
u
"}
(6,1,1) = {"
u
v
j
j
u
j
D
u
"}
(7,1,1) = {"
u
u
u
u
u
u
u
u
"}
