//MAP CONVERTED BY dmm2tgm.py THIS HEADER COMMENT PREVENTS RECONVERSION, DO NOT REMOVE
"a" = (
/turf/closed/wall/f13/tentwall,
/area/survivalpod)
"e" = (
/obj/structure/table/wood/settler,
/turf/open/indestructible/ground/outside/civ/thatch1,
/area/survivalpod)
"j" = (
/obj/effect/overlay/desert_side{
	dir = 1
	},
/turf/open/indestructible/ground/outside/civ/thatch1,
/area/survivalpod)
"m" = (
/turf/open/indestructible/ground/outside/dirt{
	icon_state = "dirtcorner"
	},
/area/survivalpod)
"o" = (
/obj/effect/overlay/desert_side,
/turf/open/indestructible/ground/outside/civ/thatch1,
/area/survivalpod)
"s" = (
/obj/structure/table/wood/settler,
/obj/machinery/microwave,
/turf/open/indestructible/ground/outside/civ/thatch1,
/area/survivalpod)
"u" = (
/turf/open/indestructible/ground/outside/dirt{
	dir = 8;
	icon_state = "dirtcorner"
	},
/area/survivalpod)
"y" = (
/obj/structure/table/wood/settler,
/obj/item/lighter,
/turf/open/indestructible/ground/outside/civ/thatch1,
/area/survivalpod)
"E" = (
/obj/structure/table/wood/settler,
/obj/machinery/chem_dispenser/drinks/beer,
/obj/item/storage/box/drinkingglasses,
/turf/open/indestructible/ground/outside/civ/thatch1,
/area/survivalpod)
"G" = (
/turf/open/indestructible/ground/outside/civ/thatch1,
/area/survivalpod)
"I" = (
/obj/effect/overlay/desert_side{
	dir = 4
	},
/turf/open/indestructible/ground/outside/civ/thatch1,
/area/survivalpod)
"J" = (
/obj/structure/reagent_dispensers/beerkeg,
/turf/open/indestructible/ground/outside/civ/thatch1,
/area/survivalpod)
"K" = (
/obj/structure/bonfire{
	pixel_x = -15;
	pixel_y = 21
	},
/turf/open/indestructible/ground/outside/dirt{
	dir = 1;
	icon_state = "dirtcorner"
	},
/area/survivalpod)
"M" = (
/obj/effect/overlay/desert_side,
/turf/open/indestructible/ground/outside/dirt{
	dir = 4;
	icon_state = "dirtcorner"
	},
/area/survivalpod)
"O" = (
/obj/structure/chair/bench,
/turf/open/indestructible/ground/outside/civ/thatch1,
/area/survivalpod)
"Q" = (
/obj/item/candle/tribal_torch,
/turf/open/indestructible/ground/outside/civ/thatch1,
/area/survivalpod)
"R" = (
/obj/effect/overlay/desert_side{
	dir = 8
	},
/turf/open/indestructible/ground/outside/civ/thatch1,
/area/survivalpod)
"T" = (
/obj/structure/simple_door/tent,
/turf/open/indestructible/ground/outside/civ/thatch1,
/area/survivalpod)
"U" = (
/obj/structure/closet/crate/wooden,
/obj/effect/spawner/lootdrop/f13/foodspawner,
/obj/effect/spawner/lootdrop/f13/foodspawner,
/turf/open/indestructible/ground/outside/civ/thatch1,
/area/survivalpod)

(1,1,1) = {"
a
a
a
a
a
a
a
a
a
a
"}
(2,1,1) = {"
a
Q
G
G
G
G
G
U
Q
a
"}
(3,1,1) = {"
a
E
G
G
O
G
G
G
U
a
"}
(4,1,1) = {"
a
J
G
G
O
G
O
G
O
a
"}
(5,1,1) = {"
a
G
G
G
O
G
O
G
O
a
"}
(6,1,1) = {"
a
G
G
I
I
G
O
G
O
a
"}
(7,1,1) = {"
a
y
o
m
M
j
G
G
G
T
"}
(8,1,1) = {"
a
e
o
u
K
j
G
G
G
T
"}
(9,1,1) = {"
a
G
G
R
R
G
O
G
O
a
"}
(10,1,1) = {"
a
G
G
G
O
G
O
G
O
a
"}
(11,1,1) = {"
a
G
G
G
O
G
G
G
O
a
"}
(12,1,1) = {"
a
s
G
G
O
G
G
G
U
a
"}
(13,1,1) = {"
a
Q
J
G
G
G
G
U
Q
a
"}
(14,1,1) = {"
a
a
a
a
a
a
a
a
a
a
"}
