//MAP CONVERTED BY dmm2tgm.py THIS HEADER COMMENT PREVENTS RECONVERSION, DO NOT REMOVE
"a" = (
/turf/closed/wall/f13/tentwall,
/area/survivalpod)
"c" = (
/obj/structure/table/wood,
/obj/item/reagent_containers/food/snacks/f13/squirrelstick,
/turf/open/floor/carpet,
/area/survivalpod)
"e" = (
/obj/structure/chair/wood,
/turf/open/floor/carpet,
/area/survivalpod)
"g" = (
/obj/structure/closet/fridge/standard,
/turf/open/floor/carpet,
/area/survivalpod)
"m" = (
/obj/structure/table/wood,
/obj/item/reagent_containers/food/snacks/f13/crispysquirrel,
/turf/open/floor/carpet,
/area/survivalpod)
"n" = (
/obj/structure/table/wood,
/obj/item/reagent_containers/food/snacks/grown/potato,
/obj/item/reagent_containers/food/snacks/grown/potato,
/obj/item/reagent_containers/food/snacks/grown/potato,
/obj/item/reagent_containers/food/snacks/grown/potato,
/obj/item/reagent_containers/food/snacks/grown/potato,
/obj/item/reagent_containers/food/snacks/grown/potato,
/obj/item/reagent_containers/food/snacks/grown/potato,
/obj/item/reagent_containers/food/snacks/grown/potato,
/obj/item/reagent_containers/food/snacks/grown/potato,
/obj/item/reagent_containers/food/snacks/grown/carrot,
/obj/item/reagent_containers/food/snacks/grown/carrot,
/obj/item/reagent_containers/food/snacks/grown/carrot,
/obj/item/reagent_containers/food/snacks/grown/carrot,
/obj/item/reagent_containers/food/snacks/grown/carrot,
/obj/item/reagent_containers/food/snacks/grown/carrot,
/obj/item/reagent_containers/food/snacks/grown/onion,
/obj/item/reagent_containers/food/snacks/grown/onion,
/obj/item/reagent_containers/food/snacks/grown/onion,
/obj/item/reagent_containers/food/snacks/grown/onion,
/obj/item/reagent_containers/food/snacks/grown/onion,
/obj/item/reagent_containers/food/snacks/grown/onion,
/obj/item/reagent_containers/food/snacks/grown/onion,
/obj/item/reagent_containers/food/snacks/grown/onion,
/turf/open/floor/carpet,
/area/survivalpod)
"q" = (
/obj/structure/table/wood,
/obj/structure/table/wood,
/obj/item/pestle,
/obj/item/reagent_containers/glass/mortar,
/obj/item/storage/bag/tray,
/turf/open/floor/carpet,
/area/survivalpod)
"s" = (
/obj/structure/sink{
	dir = 8
	},
/turf/open/floor/carpet,
/area/survivalpod)
"t" = (
/obj/structure/simple_door/tent,
/turf/open/floor/carpet,
/area/survivalpod)
"u" = (
/obj/machinery/microwave/stove,
/turf/open/floor/carpet,
/area/survivalpod)
"w" = (
/obj/structure/destructible/tribal_torch/lit,
/turf/open/indestructible/ground/outside/dirt,
/area/survivalpod)
"x" = (
/obj/structure/table/wood,
/obj/item/reagent_containers/food/snacks/f13/fried_brahmin_skin,
/obj/item/reagent_containers/food/snacks/f13/fried_brahmin_skin,
/obj/item/reagent_containers/food/snacks/f13/fried_brahmin_skin,
/obj/item/reagent_containers/food/snacks/f13/fried_brahmin_skin,
/obj/item/reagent_containers/food/snacks/f13/fried_brahmin_skin,
/obj/item/reagent_containers/food/snacks/f13/fried_brahmin_skin,
/obj/structure/destructible/tribal_torch/wall/lit{
	dir = 1
	},
/turf/open/floor/carpet,
/area/survivalpod)
"z" = (
/obj/structure/table/wood,
/obj/item/reagent_containers/food/snacks/meat/slab,
/obj/item/reagent_containers/food/snacks/meat/slab,
/obj/item/reagent_containers/food/snacks/meat/slab,
/obj/item/reagent_containers/food/snacks/meat/slab,
/turf/open/floor/carpet,
/area/survivalpod)
"C" = (
/obj/structure/table/wood,
/obj/item/reagent_containers/food/snacks/meat/slab/gecko,
/obj/item/reagent_containers/food/snacks/meat/slab/gecko,
/obj/item/reagent_containers/food/snacks/meat/slab/gecko,
/obj/item/reagent_containers/food/snacks/meat/slab/gecko,
/obj/item/reagent_containers/food/snacks/meat/slab/gecko,
/obj/item/reagent_containers/food/snacks/meat/slab/gecko,
/obj/structure/destructible/tribal_torch/wall/lit,
/turf/open/floor/carpet,
/area/survivalpod)
"D" = (
/obj/structure/table/wood,
/obj/item/reagent_containers/food/snacks/f13/molejerky,
/obj/item/reagent_containers/food/snacks/f13/molejerky,
/obj/item/reagent_containers/food/snacks/f13/molejerky,
/obj/item/reagent_containers/food/snacks/f13/molejerky,
/obj/item/reagent_containers/food/snacks/f13/molejerky,
/obj/item/reagent_containers/food/snacks/f13/molejerky,
/turf/open/floor/carpet,
/area/survivalpod)
"I" = (
/obj/structure/table/wood,
/obj/item/reagent_containers/food/snacks/f13/gecko_kebab,
/turf/open/floor/carpet,
/area/survivalpod)
"J" = (
/obj/structure/table/wood,
/turf/open/floor/carpet,
/area/survivalpod)
"P" = (
/turf/open/floor/carpet,
/area/survivalpod)
"Q" = (
/obj/structure/table/wood,
/obj/item/reagent_containers/food/snacks/f13/fried_molerat_lung,
/obj/item/reagent_containers/food/snacks/f13/fried_molerat_lung,
/obj/item/reagent_containers/food/snacks/f13/fried_molerat_lung,
/obj/item/reagent_containers/food/snacks/f13/fried_molerat_lung,
/obj/item/reagent_containers/food/snacks/f13/fried_molerat_lung,
/obj/item/reagent_containers/food/snacks/f13/fried_molerat_lung,
/obj/item/reagent_containers/food/snacks/f13/fried_molerat_lung,
/obj/item/reagent_containers/food/snacks/f13/fried_molerat_lung,
/turf/open/floor/carpet,
/area/survivalpod)
"R" = (
/obj/structure/table/wood,
/obj/machinery/processor/chopping_block,
/turf/open/floor/carpet,
/area/survivalpod)
"X" = (
/turf/open/indestructible/ground/outside/dirt,
/area/survivalpod)

(1,1,1) = {"
a
a
a
a
a
a
a
a
a
"}
(2,1,1) = {"
a
g
P
s
u
s
P
g
a
"}
(3,1,1) = {"
a
x
P
P
R
P
P
C
a
"}
(4,1,1) = {"
a
D
P
P
q
P
P
z
a
"}
(5,1,1) = {"
a
Q
P
P
P
P
P
n
a
"}
(6,1,1) = {"
a
a
J
J
t
J
J
a
a
"}
(7,1,1) = {"
a
w
P
P
P
P
P
w
a
"}
(8,1,1) = {"
a
X
P
P
P
P
P
X
a
"}
(9,1,1) = {"
X
X
e
e
e
e
e
X
X
"}
(10,1,1) = {"
X
X
c
I
c
m
I
X
X
"}
(11,1,1) = {"
X
X
e
e
e
e
e
X
X
"}
(12,1,1) = {"
a
w
X
X
X
X
X
w
a
"}
(13,1,1) = {"
a
a
a
a
a
a
a
a
a
"}
