"a" = (/obj/structure/flora/wasteplant/wild_broc,/obj/machinery/hydroponics/soil,/turf/open/indestructible/ground/outside/dirt,/area/survivalpod)
"c" = (/obj/structure/table/wood,/obj/item/pestle,/obj/item/reagent_containers/glass/mortar,/turf/open/indestructible/ground/outside/dirt,/area/survivalpod)
"d" = (/obj/structure/reagent_dispensers/compostbin,/turf/open/indestructible/ground/outside/dirt,/area/survivalpod)
"h" = (/obj/structure/bed/wooden,/turf/open/indestructible/ground/outside/dirt,/area/survivalpod)
"i" = (/obj/structure/chair/wood{dir = 0},/turf/open/indestructible/ground/outside/dirt,/area/survivalpod)
"j" = (/turf/closed/wall/f13/tentwall,/area/survivalpod)
"n" = (/obj/machinery/smartfridge/bottlerack/seedbin/primitive,/turf/open/indestructible/ground/outside/dirt,/area/survivalpod)
"p" = (/obj/machinery/smartfridge/bottlerack/alchemy_rack,/turf/open/indestructible/ground/outside/dirt,/area/survivalpod)
"r" = (/obj/item/reagent_containers/glass/bucket/wood,/obj/item/cultivator,/obj/item/shovel/spade,/turf/open/indestructible/ground/outside/dirt,/area/survivalpod)
"s" = (/obj/structure/simple_door/tentflap_cloth,/turf/open/indestructible/ground/outside/dirt,/area/survivalpod)
"x" = (/obj/machinery/smartfridge/bottlerack/grownbin,/turf/open/indestructible/ground/outside/dirt,/area/survivalpod)
"y" = (/turf/open/indestructible/ground/outside/dirt,/area/survivalpod)
"A" = (/obj/structure/destructible/tribal_torch/wall/lit,/turf/open/indestructible/ground/outside/dirt,/area/survivalpod)
"D" = (/obj/structure/sink/puddle,/turf/open/indestructible/ground/outside/dirt,/area/survivalpod)
"F" = (/obj/machinery/chem_master/primitive,/obj/structure/destructible/tribal_torch/wall/lit,/turf/open/indestructible/ground/outside/dirt,/area/survivalpod)
"I" = (/obj/structure/legion_extractor,/turf/open/indestructible/ground/outside/dirt,/area/survivalpod)
"K" = (/obj/structure/flora/wasteplant/wild_fungus,/obj/machinery/hydroponics/soil,/turf/open/indestructible/ground/outside/dirt,/area/survivalpod)
"Q" = (/obj/structure/flora/wasteplant/wild_agave,/obj/machinery/hydroponics/soil,/turf/open/indestructible/ground/outside/dirt,/area/survivalpod)
"R" = (/obj/structure/flora/wasteplant/wild_xander,/obj/machinery/hydroponics/soil,/turf/open/indestructible/ground/outside/dirt,/area/survivalpod)

(1,1,1) = {"
jjjjjj
jpcihj
jFyyAj
jjsjjj
QKyxdn
RayrDI
"}
