"a" = (/obj/structure/table/wood,/turf/open/floor/plating/f13/outside/desert,/area/survivalpod)
"c" = (/turf/closed/wall/f13/tentwall,/area/survivalpod)
"e" = (/turf/open/indestructible/ground/outside/dirt{dir = 4; icon_state = "dirtcorner"; tag = "icon-dirtcorner (EAST)"},/area/survivalpod)
"f" = (/obj/structure/table/wood,/obj/effect/spawner/lootdrop/f13/foodspawner,/obj/effect/spawner/lootdrop/f13/foodspawner,/obj/effect/spawner/lootdrop/f13/foodspawner,/turf/open/floor/f13/wood{icon_state = "housewood2"; tag = "icon-housewood2"},/area/survivalpod)
"g" = (/turf/open/floor/f13/wood{icon_state = "housewood2"; tag = "icon-housewood2"},/area/survivalpod)
"l" = (/turf/open/floor/plating/f13/outside/desert,/area/survivalpod)
"r" = (/turf/open/indestructible/ground/outside/dirt{dir = 1; icon_state = "dirt"},/area/survivalpod)
"s" = (/obj/structure/campfire/stove,/turf/open/floor/f13/wood{icon_state = "housewood2"; tag = "icon-housewood2"},/area/survivalpod)
"x" = (/obj/structure/rack,/turf/open/indestructible/ground/outside/dirt,/area/survivalpod)
"y" = (/obj/structure/table/wood,/turf/open/indestructible/ground/outside/dirt{dir = 4; icon_state = "dirtcorner"; tag = "icon-dirtcorner (EAST)"},/area/survivalpod)
"z" = (/obj/structure/table/wood,/obj/machinery/microwave,/turf/open/floor/f13/wood{icon_state = "housewood2"; tag = "icon-housewood2"},/area/survivalpod)
"D" = (/turf/open/indestructible/ground/outside/dirt{dir = 1; icon_state = "dirtcorner"},/area/survivalpod)
"E" = (/obj/structure/table/wood,/turf/open/indestructible/ground/outside/dirt{dir = 1; icon_state = "dirtcorner"; tag = "icon-dirtcorner (NORTH)"},/area/survivalpod)
"G" = (/obj/structure/barricade/bars,/obj/structure/curtain{color = "#845f58"},/turf/open/indestructible/ground/outside/dirt,/area/survivalpod)
"I" = (/turf/open/indestructible/ground/outside/dirt{dir = 9; icon_state = "dirt"; tag = "icon-dirt (NORTHWEST)"},/area/survivalpod)
"J" = (/obj/structure/simple_door/tent,/turf/open/floor/f13/wood{icon_state = "housewood2"; tag = "icon-housewood2"},/area/survivalpod)
"L" = (/obj/structure/rack,/obj/item/stack/sheet/plasteel/twenty,/obj/item/stack/sheet/paperframes/twenty,/obj/item/stack/sheet/mineral/wood/twenty,/obj/item/stack/sheet/metal/twenty,/obj/item/stack/sheet/leather/twenty,/obj/item/stack/sheet/glass/ten,/turf/open/indestructible/ground/outside/dirt,/area/survivalpod)
"M" = (/turf/open/indestructible/ground/outside/dirt{dir = 5; icon_state = "dirt"; tag = "icon-dirt (NORTHEAST)"},/area/survivalpod)
"N" = (/obj/structure/simple_door/metal/barred,/obj/structure/curtain{color = "#845f58"},/turf/open/indestructible/ground/outside/dirt,/area/survivalpod)
"O" = (/obj/structure/dresser,/turf/open/floor/f13/wood{icon_state = "housewood2"; tag = "icon-housewood2"},/area/survivalpod)
"P" = (/obj/machinery/workbench,/turf/open/indestructible/ground/outside/dirt,/area/survivalpod)
"Q" = (/turf/open/floor/plating/f13/outside/desert,/area/f13/wasteland)
"R" = (/obj/item/bedsheet/cult,/obj/structure/bed,/turf/open/floor/f13/wood{icon_state = "housewood2"; tag = "icon-housewood2"},/area/survivalpod)
"S" = (/obj/structure/simple_door/tent,/turf/open/indestructible/ground/outside/dirt{dir = 4; icon_state = "dirt"},/area/survivalpod)
"V" = (/turf/open/indestructible/ground/outside/dirt,/area/survivalpod)
"X" = (/obj/machinery/autolathe/constructionlathe,/turf/open/indestructible/ground/outside/dirt,/area/survivalpod)

(1,1,1) = {"
cccccccccc
cxLPXcfgRc
SVVVVJggOc
ccGNcczgsc
cxVVxccccc
cIrrMcQQQQ
yDlleEQQQQ
aaaaaaQQQQ
"}
