//MAP CONVERTED BY dmm2tgm.py THIS HEADER COMMENT PREVENTS RECONVERSION, DO NOT REMOVE
"a" = (
/turf/closed/wall/f13/tentwall,
/area/survivalpod)
"c" = (
/obj/structure/dresser,
/obj/item/flashlight/lamp/green{
	pixel_y = 15
	},
/turf/open/indestructible/ground/outside/civ/thatch1,
/area/survivalpod)
"d" = (
/obj/structure/bed/double,
/obj/item/bedsheet/doublesheetred{
	color = "#FF9999"
	},
/turf/open/indestructible/ground/outside/civ/thatch1,
/area/survivalpod)
"g" = (
/obj/structure/chair/stool,
/turf/open/indestructible/ground/outside/civ/thatch1,
/area/survivalpod)
"h" = (
/turf/open/indestructible/ground/outside/civ/thatch1,
/area/survivalpod)
"j" = (
/obj/machinery/shower{
	dir = 8
	},
/turf/open/indestructible/ground/outside/civ/thatch1,
/area/survivalpod)
"k" = (
/obj/structure/table/wood/settler{
	name = "tourist table"
	},
/obj/item/reagent_containers/food/snacks/f13/caravanlunch,
/obj/item/candle,
/obj/item/key,
/obj/item/lock_construct,
/turf/open/indestructible/ground/outside/civ/thatch1,
/area/survivalpod)
"n" = (
/obj/structure/simple_door/tent,
/obj/item/lock_bolt{
	dir = 1
	},
/turf/open/indestructible/ground/outside/civ/thatch1,
/area/survivalpod)
"u" = (
/obj/structure/campfire/stove,
/turf/open/indestructible/ground/outside/civ/thatch1,
/area/survivalpod)
"w" = (
/obj/structure/window/fulltile/civ/oriental_windownew,
/obj/structure/curtain/directional/south{
	color = "#FF4444"
	},
/turf/open/indestructible/ground/outside/civ/thatch1,
/area/survivalpod)
"D" = (
/obj/item/reagent_containers/food/snacks/f13/molejerky,
/obj/item/reagent_containers/food/snacks/f13/molejerky,
/obj/item/reagent_containers/food/snacks/f13/crispysquirrel,
/obj/structure/closet/crate/wicker,
/turf/open/indestructible/ground/outside/civ/thatch1,
/area/survivalpod)

(1,1,1) = {"
a
a
a
a
a
"}
(2,1,1) = {"
a
c
g
k
a
"}
(3,1,1) = {"
w
d
h
h
n
"}
(4,1,1) = {"
a
u
j
D
a
"}
(5,1,1) = {"
a
a
a
a
a
"}
