//MAP CONVERTED BY dmm2tgm.py THIS HEADER COMMENT PREVENTS RECONVERSION, DO NOT REMOVE
"a" = (
/obj/structure/rack/shelf_metal,
/turf/open/indestructible/ground/outside/dirt,
/area/survivalpod)
"j" = (
/obj/machinery/workbench/forge,
/turf/open/indestructible/ground/outside/dirt,
/area/survivalpod)
"l" = (
/obj/structure/table/wood,
/obj/item/reagent_containers/glass/bottle/welding_fuel,
/obj/item/reagent_containers/glass/bottle/welding_fuel,
/obj/item/melee/smith/hammer/premade,
/obj/item/stack/sheet/leatherstrips,
/obj/item/stack/sheet/leatherstrips,
/obj/item/stack/sheet/leatherstrips,
/obj/item/stack/sheet/leatherstrips,
/obj/item/blacksmith/woodrod,
/obj/item/blacksmith/woodrod,
/obj/item/blacksmith/woodrod,
/obj/item/blacksmith/woodrod,
/obj/structure/destructible/tribal_torch/wall/lit,
/turf/open/indestructible/ground/outside/dirt,
/area/survivalpod)
"n" = (
/obj/structure/table/wood,
/obj/structure/simple_door/tent,
/turf/open/indestructible/ground/outside/dirt,
/area/survivalpod)
"w" = (
/turf/closed/wall/f13/tentwall,
/area/survivalpod)
"D" = (
/obj/structure/rack/shelf_metal,
/obj/structure/destructible/tribal_torch/wall/lit{
	dir = 1
	},
/turf/open/indestructible/ground/outside/dirt,
/area/survivalpod)
"E" = (
/obj/structure/anvil,
/obj/structure/destructible/tribal_torch/wall/lit{
	dir = 1
	},
/turf/open/indestructible/ground/outside/dirt,
/area/survivalpod)
"K" = (
/obj/structure/furnace,
/turf/open/indestructible/ground/outside/dirt,
/area/survivalpod)
"T" = (
/obj/structure/simple_door/tent,
/turf/open/indestructible/ground/outside/dirt,
/area/survivalpod)
"V" = (
/turf/open/indestructible/ground/outside/dirt,
/area/survivalpod)

(1,1,1) = {"
w
w
w
w
w
w
w
w
"}
(2,1,1) = {"
w
j
V
V
V
V
V
n
"}
(3,1,1) = {"
w
V
V
l
w
D
V
n
"}
(4,1,1) = {"
w
E
V
K
w
a
V
n
"}
(5,1,1) = {"
w
w
T
w
w
w
w
w
"}
