//MAP CONVERTED BY dmm2tgm.py THIS HEADER COMMENT PREVENTS RECONVERSION, DO NOT REMOVE
"c" = (
/obj/structure/table/wood/settler{
	name = "tourist table"
	},
/obj/item/reagent_containers/food/snacks/f13/caravanlunch,
/obj/item/candle,
/obj/item/key,
/obj/item/lock_construct,
/turf/open/indestructible/ground/outside/civ/thatch1,
/area/survivalpod)
"f" = (
/obj/structure/bed,
/obj/item/bedsheet/black,
/turf/open/indestructible/ground/outside/civ/thatch1,
/area/survivalpod)
"j" = (
/obj/structure/chair/f13foldupchair,
/turf/open/indestructible/ground/outside/civ/thatch1,
/area/survivalpod)
"m" = (
/obj/structure/closet/crate/wooden,
/turf/open/indestructible/ground/outside/civ/thatch1,
/area/survivalpod)
"o" = (
/obj/structure/simple_door/tent,
/obj/item/lock_bolt{
	dir = 1
	},
/turf/open/indestructible/ground/outside/civ/thatch1,
/area/survivalpod)
"q" = (
/obj/machinery/light/small{
	dir = 4
	},
/turf/open/indestructible/ground/outside/civ/thatch1,
/area/survivalpod)
"u" = (
/turf/closed/wall/f13/tentwall,
/area/survivalpod)
"v" = (
/obj/structure/campfire/stove,
/turf/open/indestructible/ground/outside/civ/thatch1,
/area/survivalpod)
"x" = (
/obj/item/stack/sheet/mineral/wood/fifty,
/obj/structure/closet/crate/wooden,
/obj/item/storage/box/matches,
/turf/open/indestructible/ground/outside/civ/thatch1,
/area/survivalpod)
"y" = (
/obj/structure/window/fulltile/civ/oriental_windownew,
/obj/structure/curtain/directional/east{
	color = "#FF4444"
	},
/turf/open/indestructible/ground/outside/civ/thatch1,
/area/survivalpod)
"D" = (
/obj/machinery/light/small{
	dir = 8
	},
/turf/open/indestructible/ground/outside/civ/thatch1,
/area/survivalpod)
"G" = (
/obj/machinery/workbench,
/turf/open/indestructible/ground/outside/civ/thatch1,
/area/survivalpod)
"H" = (
/obj/structure/chair/f13foldupchair{
	dir = 8
	},
/turf/open/indestructible/ground/outside/civ/thatch1,
/area/survivalpod)
"I" = (
/obj/structure/window/fulltile/civ/oriental_windownew,
/obj/structure/curtain/directional/west{
	color = "#FF4444"
	},
/turf/open/indestructible/ground/outside/civ/thatch1,
/area/survivalpod)
"K" = (
/turf/open/indestructible/ground/outside/civ/thatch1,
/area/survivalpod)
"N" = (
/obj/structure/closet/crate/wooden,
/obj/effect/spawner/lootdrop/f13/foodspawner,
/obj/effect/spawner/lootdrop/f13/foodspawner,
/obj/effect/spawner/lootdrop/f13/foodspawner,
/obj/effect/spawner/lootdrop/f13/alcoholspawner,
/obj/effect/spawner/lootdrop/f13/alcoholspawner,
/obj/effect/spawner/lootdrop/f13/alcoholspawner,
/turf/open/indestructible/ground/outside/civ/thatch1,
/area/survivalpod)
"O" = (
/obj/structure/table/wood/settler,
/obj/machinery/chem_dispenser/drinks{
	dir = 8
	},
/turf/open/indestructible/ground/outside/civ/thatch1,
/area/survivalpod)
"P" = (
/obj/structure/chair/f13foldupchair{
	dir = 4;
	icon_state = "f13foldupchair"
	},
/turf/open/indestructible/ground/outside/civ/thatch1,
/area/survivalpod)
"Q" = (
/obj/structure/table/wood/settler,
/turf/open/indestructible/ground/outside/civ/thatch1,
/area/survivalpod)
"R" = (
/obj/structure/simple_door/tent,
/turf/open/indestructible/ground/outside/civ/thatch1,
/area/survivalpod)

(1,1,1) = {"
u
u
u
u
u
y
u
y
u
u
u
"}
(2,1,1) = {"
u
f
K
R
K
K
D
K
j
Q
u
"}
(3,1,1) = {"
u
m
K
u
K
K
K
K
K
H
u
"}
(4,1,1) = {"
u
m
K
u
K
K
K
K
K
K
u
"}
(5,1,1) = {"
u
f
q
u
x
K
K
K
K
c
u
"}
(6,1,1) = {"
u
u
u
u
v
K
K
K
K
K
o
"}
(7,1,1) = {"
u
f
D
u
N
K
K
K
K
K
u
"}
(8,1,1) = {"
u
m
K
u
G
K
K
K
K
K
u
"}
(9,1,1) = {"
u
m
K
u
K
K
K
K
K
P
u
"}
(10,1,1) = {"
u
f
K
R
K
K
q
K
j
O
u
"}
(11,1,1) = {"
u
u
u
u
u
I
u
I
u
u
u
"}
