//MAP CONVERTED BY dmm2tgm.py THIS HEADER COMMENT PREVENTS RECONVERSION, DO NOT REMOVE
"a" = (
/obj/structure/sink/puddle,
/turf/open/indestructible/ground/outside/dirt,
/area/survivalpod)
"g" = (
/turf/open/indestructible/ground/outside/dirt,
/area/survivalpod)
"i" = (
/obj/structure/reagent_dispensers/compostbin,
/turf/open/indestructible/ground/outside/dirt,
/area/survivalpod)
"v" = (
/obj/machinery/smartfridge/bottlerack/seedbin,
/turf/open/indestructible/ground/outside/dirt,
/area/survivalpod)
"B" = (
/obj/item/cultivator,
/obj/item/shovel/spade,
/obj/item/reagent_containers/glass/bucket/wood,
/turf/open/indestructible/ground/outside/dirt,
/area/survivalpod)
"C" = (
/obj/machinery/hydroponics/soil,
/obj/item/seeds/wheat,
/turf/open/indestructible/ground/outside/dirt,
/area/survivalpod)
"D" = (
/obj/structure/simple_door/metal/fence/wooden,
/turf/open/indestructible/ground/outside/dirt,
/area/survivalpod)
"H" = (
/obj/structure/legion_extractor,
/turf/open/indestructible/ground/outside/dirt,
/area/survivalpod)
"J" = (
/obj/structure/fence/wooden,
/turf/open/indestructible/ground/outside/dirt,
/area/survivalpod)
"X" = (
/mob/living/simple_animal/cow/brahmin,
/turf/open/indestructible/ground/outside/dirt,
/area/survivalpod)
"Z" = (
/obj/machinery/smartfridge/bottlerack/grownbin,
/turf/open/indestructible/ground/outside/dirt,
/area/survivalpod)

(1,1,1) = {"
J
J
J
J
J
J
J
"}
(2,1,1) = {"
J
g
g
g
g
g
J
"}
(3,1,1) = {"
J
g
X
g
X
g
J
"}
(4,1,1) = {"
J
g
g
g
g
g
J
"}
(5,1,1) = {"
J
g
g
g
X
g
J
"}
(6,1,1) = {"
J
g
g
g
g
g
J
"}
(7,1,1) = {"
J
J
J
D
J
J
J
"}
(8,1,1) = {"
Z
a
g
g
g
C
C
"}
(9,1,1) = {"
i
g
g
B
g
C
C
"}
(10,1,1) = {"
v
g
H
g
g
g
g
"}
