//MAP CONVERTED BY dmm2tgm.py THIS HEADER COMMENT PREVENTS RECONVERSION, DO NOT REMOVE
"b" = (
/obj/structure/simple_door/tent,
/turf/open/indestructible/ground/outside/dirt,
/area/survivalpod)
"c" = (
/obj/structure/chair/wood,
/turf/open/indestructible/ground/outside/dirt,
/area/survivalpod)
"F" = (
/obj/structure/campfire,
/turf/open/indestructible/ground/outside/dirt,
/area/survivalpod)
"H" = (
/obj/structure/table/wood,
/obj/effect/spawner/lootdrop/f13/alcoholspawner,
/obj/effect/spawner/lootdrop/f13/alcoholspawner,
/obj/effect/spawner/lootdrop/f13/alcoholspawner,
/obj/structure/destructible/tribal_torch/wall/lit{
	dir = 1
	},
/turf/open/indestructible/ground/outside/dirt,
/area/survivalpod)
"K" = (
/turf/open/indestructible/ground/outside/dirt,
/area/survivalpod)
"M" = (
/obj/structure/table/wood,
/obj/effect/spawner/lootdrop/f13/foodspawner,
/obj/effect/spawner/lootdrop/f13/foodspawner,
/obj/effect/spawner/lootdrop/f13/foodspawner,
/obj/structure/destructible/tribal_torch/wall/lit{
	dir = 1
	},
/turf/open/indestructible/ground/outside/dirt,
/area/survivalpod)
"N" = (
/turf/closed/wall/f13/tentwall,
/area/survivalpod)
"Y" = (
/obj/structure/bed/wooden,
/obj/structure/destructible/tribal_torch/wall/lit{
	dir = 1
	},
/turf/open/indestructible/ground/outside/dirt,
/area/survivalpod)

(1,1,1) = {"
N
N
N
N
N
N
K
"}
(2,1,1) = {"
N
Y
b
K
K
K
K
"}
(3,1,1) = {"
N
N
N
M
K
K
c
"}
(4,1,1) = {"
N
Y
b
K
K
c
F
"}
(5,1,1) = {"
N
N
N
H
K
K
c
"}
(6,1,1) = {"
N
Y
b
K
K
K
K
"}
(7,1,1) = {"
N
N
N
N
N
N
K
"}
