//MAP CONVERTED BY dmm2tgm.py THIS HEADER COMMENT PREVENTS RECONVERSION, DO NOT REMOVE
"a" = (
/turf/closed/wall/f13/tentwall,
/area/survivalpod)
"b" = (
/turf/open/indestructible/ground/outside/dirt,
/area/survivalpod)
"c" = (
/obj/item/reagent_containers/food/snacks/f13/molejerky,
/obj/item/reagent_containers/food/snacks/f13/molejerky,
/obj/item/reagent_containers/food/snacks/f13/crispysquirrel,
/obj/structure/closet/crate/wicker,
/obj/item/storage/backpack/duffelbag,
/turf/open/indestructible/ground/outside/dirt,
/area/survivalpod)
"d" = (
/obj/structure/chair/stool,
/turf/open/indestructible/ground/outside/dirt,
/area/survivalpod)
"e" = (
/obj/structure/bed/mattress{
	icon_state = "mattress1";
	name = "sleeping mat"
	},
/turf/open/indestructible/ground/outside/dirt,
/area/survivalpod)
"f" = (
/obj/structure/table/wood/settler{
	name = "tourist table"
	},
/obj/item/reagent_containers/food/snacks/f13/caravanlunch,
/obj/item/candle,
/turf/open/indestructible/ground/outside/dirt,
/area/survivalpod)
"g" = (
/obj/structure/destructible/tribal_torch{
	pixel_x = 15
	},
/turf/open/indestructible/ground/outside/dirt,
/area/survivalpod)
"h" = (
/obj/structure/simple_door/tent,
/turf/open/indestructible/ground/outside/dirt,
/area/survivalpod)

(1,1,1) = {"
a
a
a
a
a
"}
(2,1,1) = {"
a
c
d
f
a
"}
(3,1,1) = {"
a
e
g
b
h
"}
(4,1,1) = {"
a
a
a
a
a
"}
