//MAP CONVERTED BY dmm2tgm.py THIS HEADER COMMENT PREVENTS RECONVERSION, DO NOT REMOVE
"a" = (
/turf/open/indestructible/ground/outside/dirt,
/area/survivalpod)
"f" = (
/obj/structure/table/wood,
/obj/item/pestle,
/obj/item/reagent_containers/glass/mortar,
/turf/open/indestructible/ground/outside/dirt,
/area/survivalpod)
"g" = (
/obj/item/reagent_containers/glass/bucket/wood,
/obj/item/cultivator,
/obj/item/shovel/spade,
/turf/open/indestructible/ground/outside/dirt,
/area/survivalpod)
"h" = (
/obj/structure/flora/wasteplant/wild_agave,
/obj/machinery/hydroponics/soil,
/turf/open/indestructible/ground/outside/dirt,
/area/survivalpod)
"i" = (
/obj/machinery/chem_master/primitive,
/obj/structure/destructible/tribal_torch/wall/lit,
/turf/open/indestructible/ground/outside/dirt,
/area/survivalpod)
"j" = (
/obj/structure/destructible/tribal_torch/wall/lit,
/turf/open/indestructible/ground/outside/dirt,
/area/survivalpod)
"l" = (
/obj/structure/flora/wasteplant/wild_fungus,
/obj/machinery/hydroponics/soil,
/turf/open/indestructible/ground/outside/dirt,
/area/survivalpod)
"p" = (
/obj/structure/bed/wooden,
/turf/open/indestructible/ground/outside/dirt,
/area/survivalpod)
"q" = (
/obj/machinery/smartfridge/bottlerack/alchemy_rack,
/turf/open/indestructible/ground/outside/dirt,
/area/survivalpod)
"u" = (
/obj/machinery/smartfridge/bottlerack/seedbin/primitive,
/turf/open/indestructible/ground/outside/dirt,
/area/survivalpod)
"v" = (
/turf/closed/wall/f13/tentwall,
/area/survivalpod)
"x" = (
/obj/structure/legion_extractor,
/turf/open/indestructible/ground/outside/dirt,
/area/survivalpod)
"y" = (
/obj/structure/reagent_dispensers/compostbin,
/turf/open/indestructible/ground/outside/dirt,
/area/survivalpod)
"G" = (
/obj/structure/flora/wasteplant/wild_broc,
/obj/machinery/hydroponics/soil,
/turf/open/indestructible/ground/outside/dirt,
/area/survivalpod)
"H" = (
/obj/structure/flora/wasteplant/wild_xander,
/obj/machinery/hydroponics/soil,
/turf/open/indestructible/ground/outside/dirt,
/area/survivalpod)
"K" = (
/obj/structure/simple_door/tentflap_cloth,
/turf/open/indestructible/ground/outside/dirt,
/area/survivalpod)
"M" = (
/obj/machinery/smartfridge/bottlerack/grownbin,
/turf/open/indestructible/ground/outside/dirt,
/area/survivalpod)
"P" = (
/obj/structure/sink/puddle,
/turf/open/indestructible/ground/outside/dirt,
/area/survivalpod)
"X" = (
/obj/structure/chair/wood{
	dir = 0
	},
/turf/open/indestructible/ground/outside/dirt,
/area/survivalpod)

(1,1,1) = {"
v
v
v
v
h
H
"}
(2,1,1) = {"
v
q
i
v
l
G
"}
(3,1,1) = {"
v
f
a
K
a
a
"}
(4,1,1) = {"
v
X
a
v
M
g
"}
(5,1,1) = {"
v
p
j
v
y
P
"}
(6,1,1) = {"
v
v
v
v
u
x
"}
