//MAP CONVERTED BY dmm2tgm.py THIS HEADER COMMENT PREVENTS RECONVERSION, DO NOT REMOVE
"a" = (
/turf/closed/wall/f13/tentwall,
/area/survivalpod)
"c" = (
/obj/item/reagent_containers/food/snacks/f13/molejerky,
/obj/item/reagent_containers/food/snacks/f13/molejerky,
/obj/item/reagent_containers/food/snacks/f13/crispysquirrel,
/obj/structure/closet/crate/wicker,
/obj/item/storage/backpack/duffelbag,
/turf/open/indestructible/ground/outside/dirt,
/area/survivalpod)
"g" = (
/obj/structure/chair/stool,
/turf/open/indestructible/ground/outside/dirt,
/area/survivalpod)
"h" = (
/turf/open/indestructible/ground/outside/dirt,
/area/survivalpod)
"k" = (
/obj/structure/table/wood/settler{
	name = "tourist table"
	},
/obj/item/reagent_containers/food/snacks/f13/caravanlunch,
/obj/item/candle,
/obj/structure/destructible/tribal_torch/wall/lit,
/turf/open/indestructible/ground/outside/dirt,
/area/survivalpod)
"n" = (
/obj/structure/simple_door/tent,
/turf/open/indestructible/ground/outside/dirt,
/area/survivalpod)
"O" = (
/obj/structure/bed/wooden,
/turf/open/indestructible/ground/outside/dirt,
/area/survivalpod)

(1,1,1) = {"
a
a
a
a
a
"}
(2,1,1) = {"
a
c
g
k
a
"}
(3,1,1) = {"
a
O
h
h
n
"}
(4,1,1) = {"
a
a
a
a
a
"}
