"a" = (/obj/machinery/light/floor,/turf/open/floor/plasteel/f13{icon_state = "darkrustysolid"},/area/tcommsat/server)
"b" = (/obj/machinery/telecomms/server/presets/supply,/turf/open/floor/plasteel/f13{icon_state = "darkrustysolid"},/area/tcommsat/server)
"c" = (/obj/effect/turf_decal/stripes/asteroid/line{dir = 9},/turf/open/floor/circuit/telecomms/mainframe,/area/tcommsat/server)
"d" = (/obj/effect/turf_decal/stripes/asteroid/line{dir = 8},/obj/machinery/telecomms/server/presets/bos,/turf/open/floor/circuit/telecomms/mainframe,/area/tcommsat/server)
"e" = (/obj/effect/turf_decal/stripes/asteroid/line{dir = 8},/obj/machinery/telecomms/broadcaster/preset_left,/turf/open/floor/circuit/telecomms/mainframe,/area/tcommsat/server)
"f" = (/obj/effect/turf_decal/stripes/asteroid/line{dir = 8},/obj/machinery/telecomms/receiver/preset_left,/turf/open/floor/circuit/telecomms/mainframe,/area/tcommsat/server)
"g" = (/obj/effect/turf_decal/stripes/asteroid/line{dir = 6},/turf/open/floor/circuit/telecomms/mainframe,/area/tcommsat/server)
"h" = (/obj/machinery/telecomms/processor/preset_two,/obj/machinery/light/floor,/turf/open/floor/plasteel/f13{icon_state = "darkrustysolid"},/area/tcommsat/server)
"i" = (/obj/effect/turf_decal/stripes/asteroid/line{dir = 4},/obj/machinery/telecomms/server/presets/command,/turf/open/floor/circuit/telecomms/mainframe,/area/tcommsat/server)
"j" = (/obj/machinery/telecomms/processor/preset_one,/obj/machinery/light/floor,/turf/open/floor/plasteel/f13{icon_state = "darkrustysolid"},/area/tcommsat/server)
"k" = (/obj/effect/turf_decal/stripes/asteroid/corner,/turf/open/floor/circuit/telecomms/mainframe,/area/tcommsat/server)
"l" = (/obj/machinery/telecomms/server/presets/service,/turf/open/floor/circuit/telecomms/mainframe,/area/tcommsat/server)
"m" = (/obj/effect/turf_decal/stripes/asteroid/line{dir = 4},/turf/open/floor/plasteel/f13{icon_state = "darkrustysolid"},/area/tcommsat/server)
"n" = (/obj/machinery/telecomms/server/presets/ranger,/turf/open/floor/plasteel/f13{icon_state = "darkrustysolid"},/area/tcommsat/server)
"o" = (/obj/machinery/telecomms/server/presets/khans,/turf/open/floor/circuit/telecomms/mainframe,/area/tcommsat/server)
"p" = (/obj/machinery/telecomms/server/presets/security,/turf/open/floor/circuit/telecomms/mainframe,/area/tcommsat/server)
"q" = (/obj/effect/turf_decal/stripes/asteroid/line{dir = 8},/turf/open/floor/plasteel/f13{icon_state = "darkrustysolid"},/area/tcommsat/server)
"r" = (/obj/machinery/telecomms/server/presets/engineering,/turf/open/floor/circuit/telecomms/mainframe,/area/tcommsat/server)
"s" = (/obj/effect/turf_decal/stripes/asteroid/line{dir = 1},/obj/machinery/ntnet_relay,/turf/open/floor/circuit/telecomms/mainframe,/area/tcommsat/server)
"t" = (/obj/effect/turf_decal/stripes/asteroid/line{dir = 1},/turf/open/floor/circuit/telecomms/mainframe,/area/tcommsat/server)
"v" = (/obj/effect/turf_decal/stripes/asteroid/line,/turf/open/floor/circuit/telecomms/mainframe,/area/tcommsat/server)
"w" = (/obj/effect/turf_decal/stripes/asteroid/line{dir = 4},/obj/machinery/telecomms/broadcaster/preset_right,/turf/open/floor/circuit/telecomms/mainframe,/area/tcommsat/server)
"x" = (/obj/effect/turf_decal/stripes/asteroid/corner{dir = 8},/turf/open/floor/circuit/telecomms/mainframe,/area/tcommsat/server)
"y" = (/obj/machinery/telecomms/server/presets/den,/turf/open/floor/plasteel/f13{icon_state = "darkrustysolid"},/area/tcommsat/server)
"z" = (/obj/machinery/telecomms/server/presets/medical,/turf/open/floor/plasteel/f13{icon_state = "darkrustysolid"},/area/tcommsat/server)
"A" = (/obj/effect/turf_decal/stripes/asteroid/line{dir = 8},/obj/machinery/telecomms/server/presets/enclave,/turf/open/floor/circuit/telecomms/mainframe,/area/tcommsat/server)
"B" = (/turf/open/floor/plasteel/f13{icon_state = "darkrustysolid"},/area/tcommsat/server)
"C" = (/obj/machinery/telecomms/processor/preset_three,/obj/machinery/light/floor,/turf/open/floor/plasteel/f13{icon_state = "darkrustysolid"},/area/tcommsat/server)
"D" = (/obj/effect/turf_decal/stripes/asteroid/line{dir = 5},/turf/open/floor/circuit/telecomms/mainframe,/area/tcommsat/server)
"E" = (/obj/machinery/telecomms/hub/preset,/turf/open/floor/circuit/telecomms/mainframe,/area/tcommsat/server)
"G" = (/obj/machinery/telecomms/server/presets/responders,/turf/open/floor/plasteel/f13{icon_state = "darkrustysolid"},/area/tcommsat/server)
"H" = (/obj/machinery/telecomms/server/presets/legion,/turf/open/floor/circuit/telecomms/mainframe,/area/tcommsat/server)
"I" = (/obj/machinery/telecomms/processor/preset_four,/obj/machinery/light/floor,/turf/open/floor/plasteel/f13{icon_state = "darkrustysolid"},/area/tcommsat/server)
"J" = (/obj/effect/turf_decal/stripes/asteroid/line{dir = 9},/obj/machinery/telecomms/bus/preset_one,/turf/open/floor/circuit/telecomms/mainframe,/area/tcommsat/server)
"K" = (/obj/machinery/telecomms/server/presets/common,/turf/open/floor/circuit/telecomms/mainframe,/area/tcommsat/server)
"L" = (/obj/machinery/telecomms/server/presets/ncr,/turf/open/floor/plasteel/f13{icon_state = "darkrustysolid"},/area/tcommsat/server)
"N" = (/obj/machinery/telecomms/server/presets/science,/turf/open/floor/circuit/telecomms/mainframe,/area/tcommsat/server)
"O" = (/obj/effect/turf_decal/stripes/asteroid/line,/obj/machinery/telecomms/message_server,/turf/open/floor/circuit/telecomms/mainframe,/area/tcommsat/server)
"P" = (/obj/effect/turf_decal/stripes/asteroid/line{dir = 10},/obj/machinery/telecomms/bus/preset_four,/turf/open/floor/circuit/telecomms/mainframe,/area/tcommsat/server)
"Q" = (/obj/effect/turf_decal/stripes/asteroid/line{dir = 4},/obj/machinery/telecomms/receiver/preset_right,/turf/open/floor/circuit/telecomms/mainframe,/area/tcommsat/server)
"R" = (/obj/machinery/light/floor,/turf/open/floor/circuit/telecomms/mainframe,/area/tcommsat/server)
"S" = (/turf/open/floor/circuit/telecomms/mainframe,/area/tcommsat/server)
"T" = (/obj/effect/turf_decal/stripes/asteroid/corner{dir = 1},/turf/open/floor/circuit/telecomms/mainframe,/area/tcommsat/server)
"U" = (/obj/machinery/telecomms/server/presets/town,/turf/open/floor/circuit/telecomms/mainframe,/area/tcommsat/server)
"V" = (/obj/effect/turf_decal/stripes/asteroid/line{dir = 10},/turf/open/floor/circuit/telecomms/mainframe,/area/tcommsat/server)
"W" = (/obj/effect/turf_decal/stripes/asteroid/corner{dir = 4},/turf/open/floor/circuit/telecomms/mainframe,/area/tcommsat/server)
"X" = (/obj/effect/turf_decal/stripes/asteroid/line{dir = 4},/obj/machinery/telecomms/server/presets/vault,/turf/open/floor/circuit/telecomms/mainframe,/area/tcommsat/server)
"Y" = (/obj/effect/turf_decal/stripes/asteroid/line{dir = 5},/obj/machinery/telecomms/bus/preset_two,/turf/open/floor/circuit/telecomms/mainframe,/area/tcommsat/server)
"Z" = (/obj/effect/turf_decal/stripes/asteroid/line{dir = 6},/obj/machinery/telecomms/bus/preset_three,/turf/open/floor/circuit/telecomms/mainframe,/area/tcommsat/server)

(1,1,1) = {"
jctstDh
JWKyrxY
fSoRHSQ
dSzBLSi
qaSESam
ASnBGSX
eSNRpSw
PTlbUkZ
IVvOvgC
"}
