//MAP CONVERTED BY dmm2tgm.py THIS HEADER COMMENT PREVENTS RECONVERSION, DO NOT REMOVE
"a" = (
/obj/machinery/light/floor,
/turf/open/floor/plasteel/f13{
	icon_state = "darkrustysolid"
	},
/area/tcommsat/server)
"b" = (
/obj/machinery/light/floor,
/turf/open/floor/circuit/telecomms/mainframe,
/area/tcommsat/server)
"c" = (
/obj/effect/turf_decal/stripes/asteroid/line{
	dir = 9
	},
/turf/open/floor/circuit/telecomms/mainframe,
/area/tcommsat/server)
"d" = (
/obj/machinery/telecomms/server/presets/supply,
/turf/open/floor/plasteel/f13{
	icon_state = "darkrustysolid"
	},
/area/tcommsat/server)
"e" = (
/obj/machinery/telecomms/server/presets/science,
/turf/open/floor/circuit/telecomms/mainframe,
/area/tcommsat/server)
"f" = (
/obj/effect/turf_decal/stripes/asteroid/line{
	dir = 9
	},
/obj/machinery/telecomms/bus/preset_one,
/turf/open/floor/circuit/telecomms/mainframe,
/area/tcommsat/server)
"g" = (
/obj/effect/turf_decal/stripes/asteroid/line{
	dir = 8
	},
/obj/machinery/telecomms/server/presets/bos,
/turf/open/floor/circuit/telecomms/mainframe,
/area/tcommsat/server)
"h" = (
/obj/machinery/telecomms/server/presets/engineering,
/turf/open/floor/circuit/telecomms/mainframe,
/area/tcommsat/server)
"i" = (
/obj/machinery/telecomms/server/presets/khans,
/turf/open/floor/circuit/telecomms/mainframe,
/area/tcommsat/server)
"j" = (
/obj/machinery/telecomms/server/presets/service,
/turf/open/floor/circuit/telecomms/mainframe,
/area/tcommsat/server)
"k" = (
/obj/effect/turf_decal/stripes/asteroid/line{
	dir = 8
	},
/turf/open/floor/plasteel/f13{
	icon_state = "darkrustysolid"
	},
/area/tcommsat/server)
"l" = (
/obj/machinery/telecomms/processor/preset_two,
/obj/machinery/light/floor,
/turf/open/floor/plasteel/f13{
	icon_state = "darkrustysolid"
	},
/area/tcommsat/server)
"m" = (
/obj/machinery/telecomms/server/presets/legion,
/turf/open/floor/circuit/telecomms/mainframe,
/area/tcommsat/server)
"o" = (
/turf/open/floor/circuit/telecomms/mainframe,
/area/tcommsat/server)
"p" = (
/obj/effect/turf_decal/stripes/asteroid/corner,
/turf/open/floor/circuit/telecomms/mainframe,
/area/tcommsat/server)
"q" = (
/obj/effect/turf_decal/stripes/asteroid/line{
	dir = 4
	},
/obj/machinery/telecomms/broadcaster/preset_right,
/turf/open/floor/circuit/telecomms/mainframe,
/area/tcommsat/server)
"r" = (
/obj/effect/turf_decal/stripes/asteroid/line{
	dir = 6
	},
/turf/open/floor/circuit/telecomms/mainframe,
/area/tcommsat/server)
"s" = (
/obj/machinery/telecomms/processor/preset_four,
/obj/machinery/light/floor,
/turf/open/floor/plasteel/f13{
	icon_state = "darkrustysolid"
	},
/area/tcommsat/server)
"t" = (
/obj/effect/turf_decal/stripes/asteroid/corner{
	dir = 1
	},
/turf/open/floor/circuit/telecomms/mainframe,
/area/tcommsat/server)
"u" = (
/obj/effect/turf_decal/stripes/asteroid/line{
	dir = 10
	},
/obj/machinery/telecomms/bus/preset_four,
/turf/open/floor/circuit/telecomms/mainframe,
/area/tcommsat/server)
"v" = (
/obj/effect/turf_decal/stripes/asteroid/line,
/turf/open/floor/circuit/telecomms/mainframe,
/area/tcommsat/server)
"w" = (
/obj/effect/turf_decal/stripes/asteroid/line{
	dir = 4
	},
/obj/machinery/telecomms/receiver/preset_right,
/turf/open/floor/circuit/telecomms/mainframe,
/area/tcommsat/server)
"x" = (
/obj/effect/turf_decal/stripes/asteroid/line{
	dir = 6
	},
/obj/machinery/telecomms/bus/preset_three,
/turf/open/floor/circuit/telecomms/mainframe,
/area/tcommsat/server)
"y" = (
/obj/machinery/telecomms/server/presets/town,
/turf/open/floor/circuit/telecomms/mainframe,
/area/tcommsat/server)
"z" = (
/obj/effect/turf_decal/stripes/asteroid/line{
	dir = 1
	},
/obj/machinery/ntnet_relay,
/turf/open/floor/circuit/telecomms/mainframe,
/area/tcommsat/server)
"A" = (
/obj/machinery/telecomms/server/presets/ranger,
/turf/open/floor/plasteel/f13{
	icon_state = "darkrustysolid"
	},
/area/tcommsat/server)
"B" = (
/obj/effect/turf_decal/stripes/asteroid/line{
	dir = 5
	},
/turf/open/floor/circuit/telecomms/mainframe,
/area/tcommsat/server)
"C" = (
/obj/machinery/telecomms/server/presets/den,
/turf/open/floor/plasteel/f13{
	icon_state = "darkrustysolid"
	},
/area/tcommsat/server)
"D" = (
/obj/machinery/telecomms/processor/preset_one,
/obj/machinery/light/floor,
/turf/open/floor/plasteel/f13{
	icon_state = "darkrustysolid"
	},
/area/tcommsat/server)
"E" = (
/obj/effect/turf_decal/stripes/asteroid/line{
	dir = 4
	},
/turf/open/floor/plasteel/f13{
	icon_state = "darkrustysolid"
	},
/area/tcommsat/server)
"F" = (
/obj/effect/turf_decal/stripes/asteroid/line{
	dir = 1
	},
/turf/open/floor/circuit/telecomms/mainframe,
/area/tcommsat/server)
"H" = (
/obj/effect/turf_decal/stripes/asteroid/line{
	dir = 8
	},
/obj/machinery/telecomms/receiver/preset_left,
/turf/open/floor/circuit/telecomms/mainframe,
/area/tcommsat/server)
"I" = (
/obj/machinery/telecomms/hub/preset,
/turf/open/floor/circuit/telecomms/mainframe,
/area/tcommsat/server)
"J" = (
/turf/open/floor/plasteel/f13{
	icon_state = "darkrustysolid"
	},
/area/tcommsat/server)
"L" = (
/obj/machinery/telecomms/server/presets/medical,
/turf/open/floor/plasteel/f13{
	icon_state = "darkrustysolid"
	},
/area/tcommsat/server)
"M" = (
/obj/effect/turf_decal/stripes/asteroid/line{
	dir = 8
	},
/obj/machinery/telecomms/server/presets/enclave,
/turf/open/floor/circuit/telecomms/mainframe,
/area/tcommsat/server)
"N" = (
/obj/effect/turf_decal/stripes/asteroid/corner{
	dir = 8
	},
/turf/open/floor/circuit/telecomms/mainframe,
/area/tcommsat/server)
"O" = (
/obj/effect/turf_decal/stripes/asteroid/corner{
	dir = 4
	},
/turf/open/floor/circuit/telecomms/mainframe,
/area/tcommsat/server)
"P" = (
/obj/effect/turf_decal/stripes/asteroid/line{
	dir = 10
	},
/turf/open/floor/circuit/telecomms/mainframe,
/area/tcommsat/server)
"Q" = (
/obj/effect/turf_decal/stripes/asteroid/line{
	dir = 4
	},
/obj/machinery/telecomms/server/presets/vault,
/turf/open/floor/circuit/telecomms/mainframe,
/area/tcommsat/server)
"R" = (
/obj/machinery/telecomms/server/presets/responders,
/turf/open/floor/plasteel/f13{
	icon_state = "darkrustysolid"
	},
/area/tcommsat/server)
"S" = (
/obj/effect/turf_decal/stripes/asteroid/line{
	dir = 8
	},
/obj/machinery/telecomms/broadcaster/preset_left,
/turf/open/floor/circuit/telecomms/mainframe,
/area/tcommsat/server)
"T" = (
/obj/effect/turf_decal/stripes/asteroid/line{
	dir = 5
	},
/obj/machinery/telecomms/bus/preset_two,
/turf/open/floor/circuit/telecomms/mainframe,
/area/tcommsat/server)
"U" = (
/obj/effect/turf_decal/stripes/asteroid/line{
	dir = 4
	},
/obj/machinery/telecomms/server/presets/command,
/turf/open/floor/circuit/telecomms/mainframe,
/area/tcommsat/server)
"V" = (
/obj/machinery/telecomms/server/presets/common,
/turf/open/floor/circuit/telecomms/mainframe,
/area/tcommsat/server)
"W" = (
/obj/effect/turf_decal/stripes/asteroid/line,
/obj/machinery/telecomms/message_server,
/turf/open/floor/circuit/telecomms/mainframe,
/area/tcommsat/server)
"X" = (
/obj/machinery/telecomms/processor/preset_three,
/obj/machinery/light/floor,
/turf/open/floor/plasteel/f13{
	icon_state = "darkrustysolid"
	},
/area/tcommsat/server)
"Y" = (
/obj/machinery/telecomms/server/presets/security,
/turf/open/floor/circuit/telecomms/mainframe,
/area/tcommsat/server)
"Z" = (
/obj/machinery/telecomms/server/presets/ncr,
/turf/open/floor/plasteel/f13{
	icon_state = "darkrustysolid"
	},
/area/tcommsat/server)

(1,1,1) = {"
D
f
H
g
k
M
S
u
s
"}
(2,1,1) = {"
c
O
o
o
a
o
o
t
P
"}
(3,1,1) = {"
F
V
i
L
o
A
e
j
v
"}
(4,1,1) = {"
z
C
b
J
I
J
b
d
W
"}
(5,1,1) = {"
F
h
m
Z
o
R
Y
y
v
"}
(6,1,1) = {"
B
N
o
o
a
o
o
p
r
"}
(7,1,1) = {"
l
T
w
U
E
Q
q
x
X
"}
